지역,도서관명,도서구입비,인건비,운영비,합계
강원 원주시,(사)원주자유시장작은도서관,0,5580,240000,245580
강원 영월군,YW Vision 도서관,2000000,0,1000000,3000000
강원 강릉시,강릉 영어 작은도서관,3000000,15000000,5000000,23000000
강원 강릉시,강릉금호어울림 작은도서관,0,0,0,0
강원 횡성군,강림면 치악산 작은도서관,5000000,16838000,2348710,24186710
강원 속초시,고맙습니다풀이음작은도서관,16279850,89230220,15581580,121091650
강원 횡성군,공근면 금계 작은도서관,4997470,14555820,11471720,31025010
강원 강릉시,과학산업작은도서관,0,0,0,0
강원 강릉시,관아 작은도서관,20000000,15000000,5000000,40000000
강원 동해시,글여울도서관,1200000,0,2400000,3600000
강원 정선군,길운작은도서관,0,0,0,0
강원 춘천시,꾸러기어린이도서관,3000000,1200000,6000000,10200000
강원 원주시,꿈꾸는 도서관,0,0,0,0
강원 춘천시,꿈너머꿈,200000,0,3400000,3600000
강원 정선군,꿈을 파는 작은도서관,0,0,0,0
강원 영월군,꿈을담은도서관,2000000,0,1000000,3000000
강원 태백시,꿈을심어주는마을문고,0,0,0,0
강원 삼척시,꿈을이루는도서관,1500000,0,0,1500000
강원 강릉시,꿈이있는 작은도서관,0,0,0,0
강원 강릉시,꿈쟁이문고,0,0,0,0
강원 원주시,꿈터도서관,0,0,0,0
강원 강릉시,남산작은도서관,9500000,38000000,1000000,48500000
강원 삼척시,남양 작은도서관,0,40081,18000,58081
강원 원주시,남원주작은도서관,500000,0,1500000,2000000
강원 원주시,너울문화사랑방,0,0,1000000,1000000
강원 정선군,노엘문고,2000000,0,10000000,12000000
강원 평창군,눈마을작은도서관,4100000,19500000,29200000,52800000
강원 화천군,느릅마을작은도서관,3000000,0,0,3000000
강원 원주시,느티나무도서관,1200000,0,2000000,3200000
강원 삼척시,늘푸른문고,0,0,0,0
강원 정선군,다니엘 작은도서관,500000,0,1000000,1500000
강원 태백시,다솔도서관,0,0,0,0
강원 원주시,단계은행 작은도서관,0,0,0,0
강원 춘천시,달팽이도서관,528000,100000,7398122,8026122
강원 강릉시,대우이안강릉타운작은도서관,0,0,0,0
강원 속초시,대포마을문고,300000,1200000,1500000,3000000
강원 동해시,동성마을문고,4000000,0,15000000,19000000
강원 태백시,동점마을도서관,0,0,0,0
강원 동해시,동해문화커뮤니티센터,600000,0,0,600000
강원 동해시,동호동새힘새마을문고,500000,0,2000000,2500000
강원 원주시,두란노 작은도서관,0,0,0,0
강원 홍천군,두란노어린이도서관,187200,3600000,7200000,10987200
강원 원주시,두산위브,0,0,0,0
강원 춘천시,뒤뚜르어린이도서관,912000,6500000,9388000,16800000
강원 동해시,등대작은도서관,9510000,21500000,2000000,33010000
강원 춘천시,뜨란채도서관,2000000,0,2090000,4090000
강원 춘천시,로뎀나무문고,2300000,3000000,1200000,6500000
강원 강릉시,로하스강릉작은도서관,15470000,15000000,1000000,31470000
강원 인제군,마리서사작은도서관,4900000,4070000,0,8970000
강원 강릉시,마실작은도서관,14000000,16000000,7000000,37000000
강원 동해시,만나문고,500000,0,1560000,2060000
강원 원주시,명륜나눔도서관,2213490,0,1568710,3782200
강원 동해시,무릉작은도서관,4000000,21500000,2000000,27500000
강원 원주시,무실주공1단지 작은도서관,0,0,0,0
강원 정선군,무지개 작은도서관,0,0,0,0
강원 동해시,묵호동새마을문고,1000000,0,2400000,3400000
강원 정선군,문래문고,0,0,4000000,4000000
강원 강릉시,문화작은도서관,10736000,30000000,1000000,41736000
강원 태백시,미동문고,0,0,0,0
강원 원주시,미래작은도서관,0,0,0,0
강원 삼척시,미로지역 행복도서관 ,200000,0,0,200000
강원 원주시,민들레도서관,0,0,0,0
강원 원주시,민토,0,0,0,0
강원 원주시,반곡벽산블루밍도서관,0,0,0,0
강원 원주시,반곡아이파크 작은도서관,1000000,7000000,0,8000000
강원 삼척시,반석작은도서관,0,0,0,0
강원 춘천시,반올림도서관,0,0,200000,200000
강원 동해시,발한동새마을문고,1500000,0,6000000,7500000
강원 인제군,백담솔방울도서관,3000000,0,0,3000000
강원 강릉시,봄빛작은도서관,0,0,0,0
강원 원주시,봉산샘터 작은도서관,1000000,0,1000000,2000000
강원 동해시,북삼동 새마을문고,700000,0,4000000,4700000
강원 고성군,빨간머리앤의작은책마을,500000,0,6000000,6500000
강원 강릉시,쁘레네작은도서관 별찌,0,0,13000000,13000000
강원 원주시,쁘레네작은도서관별찌,200000,0,9000000,9200000
강원 원주시,쁘레네작은도서관별찌(명륜점),1300000,8400000,15000000,24700000
강원 화천군,사내작은도서관,3000000,0,0,3000000
강원 동해시,삼흥마을문고,100000,0,1300000,1400000
강원 원주시,상록작은도서관,2500000,6000000,3000000,11500000
강원 원주시,새능력작은도서관,100000,0,100000,200000
강원 춘천시,새마을작은도서관( 구 그린새마을열린문고),500000,0,2678551,3178551
강원 고성군,새문문고,0,0,0,0
강원 인제군,서화평화도서관,3500000,0,600000,4100000
강원 삼척시,선한문고,0,0,0,0
강원 강릉시,성남시장작은도서관,1000000,1500000,5000000,7500000
강원 강릉시,성덕반딧불작은도서관,13286000,3000000,10000000,26286000
강원 원주시,세인도서방,2400000,0,200000,2600000
강원 태백시,소도교회독서실,0,0,6000000,6000000
강원 홍천군,소망 작은도서관,600000,0,0,600000
강원 강릉시,소망우리작은도서관,0,0,0,0
강원 강릉시,솔올꿈나무작은도서관,6300000,1500000,5000000,12800000
강원 강릉시,솔올작은도서관,0,0,0,0
강원 강릉시,송정해변신도브래뉴아파트작은도서관,0,0,0,0
강원 영월군,숲속에서꿈꾸는도서관,2000000,0,500000,2500000
강원 인제군,숲으로 작은도서관,3500000,0,0,3500000
강원 춘천시,스무숲도서관,1200000,0,1200000,2400000
강원 강릉시,스카이문고,0,0,0,0
강원 원주시,신화마을도서관,0,0,0,0
강원 삼척시,아낌없이 주는 나무,0,0,0,0
강원 삼척시,아낌없이주는나무,500000,0,0,500000
강원 정선군,아우라지작은도서관,0,0,0,0
강원 원주시,아이사랑 도서관,0,0,0,0
강원 춘천시,앞짱어린이도서관,1391750,550000,11179827,13121577
강원 원주시,양문 작은 도서관,0,3000000,2000000,5000000
강원 양양군,양양감리교회작은도서관,2000000,0,1200000,3200000
강원 영월군,여행자의노래도서관,3000000,0,40000000,43000000
강원 원주시,영강도서관,0,0,0,0
강원 속초시,영랑작은도서관,6000000,38848730,4444860,49293590
강원 원주시,영재도서관,3000000,27000000,3000000,33000000
강원 원주시,영천작은도서관,0,0,0,0
강원 원주시,예꿈터 작은 도서관,1000000,0,500000,1500000
강원 춘천시,오스타작은도서관,500000,0,0,500000
강원 강릉시,옥거리작은도서관,17786000,1500000,10000000,29286000
강원 동해시,우리들 작은도서관,1500000,0,1000000,2500000
강원 횡성군,우천면 매화작은도서관,35409700,2880780,3377700,41668180
강원 강릉시,웅진다책문고,0,0,0,0
강원 동해시,웅진다책문고,7000000,0,1200000,8200000
강원 원주시,원주YMCA아름드리도서관,1600000,0,600000,2200000
강원 원주시,원주단관영어도서관,0,0,0,0
강원 강릉시,월대산작은도서관,10000000,15000000,5000000,30000000
강원 원주시,은혜어린이도서관,0,0,0,0
강원 동해시,이도작은도서관,3600000,21500000,2000000,27100000
강원 태백시,작은도서관 꿈,0,0,0,0
강원 춘천시,작은도서관별찌(2012년개관),2540000,8400000,15600000,26540000
강원 태백시,장성문고,0,0,0,0
강원 정선군,정선꿈꾸는도서관,1520000,0,4680000,6200000
강원 고성군,죽왕문고,0,0,4800000,4800000
강원 홍천군,진리도서관,300000,0,700000,1000000
강원 원주시,참꽃작은도서관,0,0,0,0
강원 춘천시,책날개어린이도서관,200000,0,100000,300000
강원 춘천시,책드림도서관,3900000,15600000,1500000,21000000
강원 동해시,천곡동 새마을문고,2400000,0,4320000,6720000
강원 양양군,천복작은도서관,1250000,0,0,1250000
강원 고성군,천진문고,0,0,0,0
강원 태백시,철암도서관,0,0,0,0
강원 원주시,청소년 문고,0,0,0,0
강원 횡성군,청일면 버들골작은도서관,4999680,18659240,5300380,28959300
강원 강릉시,초당작은도서관,13486000,30000000,5000000,48486000
강원 동해시,초록도서관,1200000,0,5000000,6200000
강원 춘천시,춘천YMCA푸름이도서관,0,0,0,0
강원 원주시,큰사랑문고,2000000,500000,240000,2740000
강원 정선군,탄광촌 생명의 양식문고,150000,0,1200000,1350000
강원 태백시,태백 인표어린이도서관,0,0,0,0
강원 원주시,태장도서관,33000000,0,0,33000000
강원 강릉시,포남어울림작은도서관,14600000,30000000,10000000,54600000
강원 원주시,푸른초장 작은도관,0,0,0,0
강원 화천군,하남옹달샘작은도서관,3000000,0,0,3000000
강원 홍천군,하늘마루 작은도서관,0,0,0,0
강원 강릉시,하슬라작은도서관,4486000,15000000,5000000,24486000
강원 태백시,한빛사랑문고,0,0,0,0
강원 강릉시,한송작은도서관,0,0,0,0
강원 양양군,해누리글터 작은도서관,1250000,0,240000,1490000
강원 태백시,햇살 도서관,0,0,0,0
강원 원주시,햇살작은도서관,0,0,0,0
강원 평창군,행복한 문고,1000000,0,15000000,16000000
강원 태백시,행복한도서관,1000000,0,0,1000000
강원 횡성군,횡성느티나무작은도서관,4998750,55050790,12044540,72094080
강원 원주시,흥업작은도서관,0,0,0,0
강원 홍천군,희망 숲 작은도서관,0,0,0,0
강원 태백시,희망의문고,0,0,0,0
경기 파주시,(사)행복한아침독서 책마을도서관,0,20300000,4000000,24300000
경기 성남시,1318하랑작은도서관,300000,1200000,1200000,2700000
경기 고양시,7단지 숲속도서관,2000000,0,1000000,3000000
경기 양주시,BOOK소리작은도서관,1500000,0,2700000,4200000
경기 고양시,Book Tree(북트리),3500000,7450000,1920000,12870000
경기 남양주시,ESR영어작은도서관,5000000,0,2000000,7000000
경기 의정부시,HAHA Asian Library,3303542,3600000,445340,7348882
경기 안산시,HJ제니스작은도서관,1500000,2400000,3500000,7400000
경기 오산시,KCC스위첸아파트 작은도서관,1200000,3360000,240000,4800000
경기 군포시,LG신산본자이2차아파트문고,0,0,0,0
경기 평택시,THE기쁜어린이도서관,6608280,14080000,24952670,45640950
경기 양주시,TS푸른솔작은도서관,0,0,4000000,4000000
경기 남양주시,가곡힘찬문고,2000000,0,1200000,3200000
경기 의정부시,가능1동작은도서관,7000000,13800000,1992857,22792857
경기 의정부시,가능2동작은도서관,6000000,13800000,1992857,21792857
경기 의정부시,가능3동작은도서관,5400000,13800000,1992857,21192857
경기 김포시,가온누리 작은도서관,0,0,0,0
경기 성남시,가온누리작은도서관,509500,7351500,2233630,10094630
경기 남양주시,가운4단지문고,1000000,0,0,1000000
경기 남양주시,가운휴먼시아5단지 도서관,1000000,0,1200000,2200000
경기 고양시,가좌대우푸르지오,2400000,0,3000000,5400000
경기 화성시,갈담 작은도서관,2000000,3000000,1000000,6000000
경기 성남시,갈보리 작은도서관,5000000,12000000,20000000,37000000
경기 시흥시,감나무골작은도서관,0,0,6627330,6627330
경기 남양주시,강변교회 어린이도서관,0,0,0,0
경기 남양주시,강변해태아파트 도서관,0,0,0,0
경기 양평군,강상작은도서관 ,29971900,3209360,1485700,34666960
경기 고양시,강아지똥 어린이도서관,2118355,5600000,6360000,14078355
경기 고양시,강촌공원 5분걸음 예쁜도서관,8400000,16128000,3480000,28008000
경기 양평군,강하 작은 도서관,1639700,15630000,1807750,19077450
경기 양주시,개척병영작은도서관,0,0,0,0
경기 파주시,거북작은도서관,4400000,0,5000000,9400000
경기 시흥시,건영1차아파트,0,0,0,0
경기 남양주시,건영리버파크아파트문고,1800000,0,700000,2500000
경기 용인시,건영캐스빌상앗대문고,500000,0,0,500000
경기 시흥시,검바위초작은도서관,6000000,0,4000000,10000000
경기 성남시,겨자씨작은도서관,2000000,2400000,3600000,8000000
경기 양주시,격파병영작은도서관,300000,0,0,300000
경기 수원시,경기다문화 도서관,0,0,0,0
경기 용인시,경남꿈모아도서관,0,0,0,0
경기 용인시,경남초록작은도서관,2000000,0,2000000,4000000
경기 남양주시,경성큰마을 작은도서관,5100000,0,600000,5700000
경기 평택시,고궁마을문고,500000,0,0,500000
경기 연천군,고대산병영도서관,360000,0,300000,660000
경기 수원시,고등동 새마을문고,5000000,0,2400000,7400000
경기 부천시,고리울꿈터작은도서관,8400000,21813900,21584420,51798320
경기 용인시,고매2통 작은도서관,0,0,2400000,2400000
경기 고양시,고양 작은도서관,11842370,20645440,8912190,41400000
경기 고양시,고양윤창 작은도서관,12226870,20775870,8197260,41200000
경기 오산시,고인돌도서관,0,0,0,0
경기 안산시,고잔2동당곡작은도서관,30000000,37273000,42103000,109376000
경기 안산시,고잔차세대작은도서관,100000,0,6000000,6100000
경기 김포시,고촌 작은도서관,3000000,16000000,3100000,22100000
경기 오산시,고현초도서관,16597000,3500000,0,20097000
경기 수원시,곡선동 새마을문고,5000000,0,2400000,7400000
경기 김포시,곡촌마을 다솜 작은도서관,0,0,0,0
경기 성남시,공감의 뜰작은도서관,0,0,0,0
경기 군포시,공군 제8249부대,2720000,0,880000,3600000
경기 안성시,공도새마을문고 청소년공부방,2679900,12000000,9020100,23700000
경기 시흥시,공룡도서관(거모복지관),0,0,2000000,2000000
경기 수원시,공부잘하는 독서학교,100000,0,0,100000
경기 고양시,관산 작은도서관,13406500,20645490,7786250,41838240
경기 고양시,관산주공아파트도서관,1000000,1800000,300000,3100000
경기 안양시,관양2동 주민센터,993240,3600000,41800,4635040
경기 포천시,관인작은도서관,5300000,0,0,5300000
경기 수원시,광교동 새마을문고,5000000,0,2400000,7400000
경기 수원시,광교해모로 숲속작은도서관,2000000,0,0,2000000
경기 수원시,광교호반 책마루도서관,6100000,0,14000000,20100000
경기 광명시,광남새마을금고 소하지점 작은도서관,5020700,1580000,0,6600700
경기 광명시,광남새마을금고 작은도서관,3200000,14800000,2050000,20050000
경기 광명시,광명6동 작은도서관,1600000,0,1232000,2832000
경기 광명시,광명드림스타트 새싹도서관,2803550,20100040,5268710,28172300
경기 광명시,광명역세권4단지 작은도서관,0,2400000,1800000,4200000
경기 광명시,광명옹달샘도서관,15225310,51151960,13785870,80163140
경기 광명시,광명한우리독서 작은도서관,2000000,0,0,2000000
경기 수원시,광민작은도서관,0,0,2400000,2400000
경기 수원시,광성꿈나무도서관,500000,6000000,3600000,10100000
경기 고양시,광성북카페,1000000,0,0,1000000
경기 광명시,광일 작은도서관,0,0,0,0
경기 양주시,광적농협작은도서관,0,0,500000,500000
경기 파주시,광탄작은도서관,14120000,5000000,5880000,25000000
경기 구리시,교문2동작은도서관,5621500,33472220,6456000,45549720
경기 김포시,구래 작은도서관,10000000,16000000,4200000,30200000
경기 광명시,구름산햇빛 작은도서관,5000000,0,5000000,10000000
경기 안양시,구름울 ,1700000,0,1320000,3020000
경기 구리시,구리 한우리 독서문화원,0,0,7200,7200
경기 성남시,구미1동작은도서관,2000000,19093000,2000000,23093000
경기 안산시,구세군다문화꿈꾸는작은도서관,0,0,0,0
경기 여주시,구세군작은도서관,0,0,1400000,1400000
경기 포천시,구세군포천교회작은도서관,0,0,0,0
경기 수원시,구운동새마을문고,5000000,0,2400000,7400000
경기 양주시,국군병원작은도서관,0,0,300000,300000
경기 군포시,군포경찰서작은도서관,0,0,0,0
경기 군포시,군포새마을문고,0,15000000,0,15000000
경기 용인시,굿모닝 작은도서관,2360000,0,6560000,8920000
경기 군포시,궁내동작은도서관,4780000,4920000,2727000,12427000
경기 남양주시,궁의문도서실,1200000,2400000,2300000,5900000
경기 수원시,권선1동 새마을문고,5000000,0,2400000,7400000
경기 수원시,권선2동 새마을문고,5000000,0,2400000,7400000
경기 고양시,권율 작은도서관,4500000,0,500000,5000000
경기 안양시,귀인동주민센타,1700000,0,0,1700000
경기 김포시,그루터기 작은도서관,0,6000000,600000,6600000
경기 용인시,그루터기도서관,500000,200000,500000,1200000
경기 부천시,글마루작은도서관,9600000,21813900,25517000,56930900
경기 양주시,글마루작은도서관,2689690,0,1273420,3963110
경기 양주시,글벗작은도서관,200000,0,2800000,3000000
경기 의왕시,글빛도서관,432000,2688000,380000,3500000
경기 수원시,글샘작은도서관,300000,0,700000,1000000
경기 파주시,글향기도서관,1200000,3600000,1200000,6000000
경기 고양시,글향기도서관,300000,0,300000,600000
경기 화성시,글향기도서실,3799830,600000,388400,4788230
경기 성남시,글향기작은도서관,769450,0,2830550,3600000
경기 파주시,금곡작은도서관,4750000,13144020,9855980,27750000
경기 남양주시,금곡푸른꿈작은도서관,7200000,43600000,2000000,52800000
경기 성남시,금광2동작은도서관,4926850,25666380,1580000,32173230
경기 오산시,금암마을 5단지 도서관,0,0,0,0
경기 군포시,금정작은도서관,3000000,0,2000000,5000000
경기 수원시,금호동새마을문고,5000000,0,2400000,7400000
경기 용인시,금화작은도서관,400000,0,3200000,3600000
경기 화성시,기아행복마루작은도서관,12000000,19200000,8466000,39666000
경기 부천시,길벗작은도서관,650000,0,870000,1520000
경기 시흥시,길벗작은도서관,1000000,300000,500000,1800000
경기 화성시,꽃담,2585000,6000000,3600000,12185000
경기 화성시,꽃동산 작은도서관,4700000,1000000,1300000,7000000
경기 안산시,꽃우물 작은도서관,2600000,4800000,1000000,8400000
경기 화성시,꽃초롱,2671500,2609700,3303800,8585000
경기 안성시,꽃피는도서관,200000,0,1000000,1200000
경기 남양주시,꿈 이안 작은도서관,7500000,0,3600000,11100000
경기 성남시,꿈&휴도서관,3000000,14400000,14762276,32162276
경기 남양주시,꿈그린작은도서관,2400000,0,3600000,6000000
경기 안양시,꿈꾸는,200000,0,100000,300000
경기 하남시,꿈꾸는 달팽이 작은도서관,1200000,2800000,3000000,7000000
경기 하남시,꿈꾸는 에코 작은도서관 ,4800000,1330000,3870000,10000000
경기 용인시,꿈꾸는 작은도서관,4000000,0,4800000,8800000
경기 안산시,꿈꾸는 작은도서관,3000000,10000000,2000000,15000000
경기 광명시,꿈꾸는나무 작은도서관,5400000,0,5900000,11300000
경기 화성시,꿈꾸는도서관,4000000,5000000,2000000,11000000
경기 연천군,꿈꾸는문고,0,0,0,0
경기 부천시,꿈꾸는새싹도서관,10000000,21813900,28513530,60327430
경기 구리시,꿈꾸는작은도서관,0,0,0,0
경기 파주시,꿈꾸는작은도서관,1844550,1200000,1804770,4849320
경기 화성시,꿈나래문고 작은도서관,2400000,0,1200000,3600000
경기 안양시,꿈나무,10000000,0,53000000,63000000
경기 화성시,꿈나무 영어 작은도서관,2500000,0,500000,3000000
경기 부천시,꿈나무가족도서관,10000000,21813900,19175000,50988900
경기 안산시,꿈나무작은도서관,2000000,4800000,1000000,7800000
경기 시흥시,꿈나무작은도서관,0,0,5000000,5000000
경기 화성시,꿈나무작은도서관,3317120,4000000,1261200,8578320
경기 성남시,꿈너비작은도서관,500000,0,250000,750000
경기 화성시,꿈누리,3992040,4000000,594630,8586670
경기 용인시,꿈누리도서관,2500000,0,4800000,7300000
경기 수원시,꿈동산 문고,0,0,0,0
경기 군포시,꿈드림작은도서관,3319810,0,173100,3492910
경기 양주시,꿈드림작은도서관,200000,0,1300000,1500000
경기 안양시,꿈마루,9000000,18900000,6000000,33900000
경기 용인시,꿈마루도서관,0,0,3000000,3000000
경기 김포시,꿈마을문고,3000000,12000000,1600000,16600000
경기 광주시,꿈마을작은도서관,2000000,18000000,18000000,38000000
경기 양주시,꿈모리작은도서관,2000000,0,4200000,6200000
경기 용인시,꿈모아도서관,5400000,0,4260000,9660000
경기 오산시,꿈밀림도서관,0,0,0,0
경기 안산시,꿈바라기 작은도서관,0,0,14000000,14000000
경기 부천시,꿈사랑작은도서관,0,0,0,0
경기 용인시,꿈샘도서관,0,0,0,0
경기 시흥시,꿈샘작은도서관,0,0,0,0
경기 김포시,꿈에그린 도서관,3466260,0,0,3466260
경기 오산시,꿈에그린 도서관,100000,200000,0,300000
경기 안산시,꿈을 주는 작은도서관,7000000,0,7980000,14980000
경기 안산시,꿈을 키우는 작은도서관,10000000,63938727,21683273,95622000
경기 광명시,꿈을찾는 작은영어도서관,5000000,0,300000,5300000
경기 부천시,꿈의지우 작은도서관,0,0,0,0
경기 광명시,꿈이 열리는 작은도서관,1000000,0,0,1000000
경기 고양시,꿈이 있는 숲 도서관,500000,0,600000,1100000
경기 수원시,꿈이 자라는 마을,0,0,1200000,1200000
경기 안양시,꿈이있는,1700000,0,1320000,3020000
경기 용인시,꿈이자라는 땅,500000,0,300000,800000
경기 용인시,꿈이자라는도서관,4000000,0,3600000,7600000
경기 하남시,꿈자람 작은도서관,9304000,3780000,500000,13584000
경기 광주시,꿈자람도서관,4600000,3600000,25590000,33790000
경기 광주시,꿈자람어린이도서관,0,0,8000000,8000000
경기 평택시,꿈쟁이 작은도서관(하북작은도서관에서 명칭변경),2000000,7200000,4800000,14000000
경기 군포시,꿈쟁이도서관,2000000,3600000,15000000,20600000
경기 화성시,꿈쟁이사립문고,3000000,0,5500000,8500000
경기 광명시,꿈크리 작은도서관,3300000,1400000,1800000,6500000
경기 안양시,꿈터,0,1700000,1320000,3020000
경기 오산시,꿈터도서관,500000,0,0,500000
경기 안양시,나누미,1700000,0,1320000,3020000
경기 의정부시,나누미작은도서관,3795120,3298250,2228510,9321880
경기 연천군,나눔과기쁨 대광북카페,0,0,0,0
경기 수원시,나눔도서관,500000,6000000,15000000,21500000
경기 의정부시,나눔작은도서관,740500,1355000,906446,3001946
경기 수원시,나란다 도서관,1000000,6000000,3000000,10000000
경기 화성시,나루꿈에그린 작은도서관,3000000,5800000,2000000,10800000
경기 부천시,나무숲작은도서관,0,0,0,0
경기 고양시,나무와열매문고,3000000,0,500000,3500000
경기 수원시,나무터작은도서관,0,0,0,0
경기 성남시,나침반 작은도서관,0,0,0,0
경기 용인시,남사면 작은도서관,400000,9600000,5000000,15000000
경기 고양시,낮은하늘어린이도서관,2000000,0,1600000,3600000
경기 안양시,내방새,1700000,0,1320000,3020000
경기 의왕시,내손e편한세상 도서관,2500000,18000000,2000000,22500000
경기 의왕시,내손책고운도서관,11400000,57763000,7014000,76177000
경기 포천시,내촌작은도서관,7550000,9860000,0,17410000
경기 광명시,넓은세상 작은도서관,4000000,0,2400000,6400000
경기 광명시,넝쿨 어린이 작은도서관,3200000,0,2050000,5250000
경기 성남시,넥슨작은책방 도서관,0,0,0,0
경기 군포시,노루목작은도서관,1360000,1200000,3440000,6000000
경기 의정부시,녹양동작은도서관,7200000,13800000,1992857,22992857
경기 성남시,논골작은도서관,9749870,93826739,57946980,161523589
경기 화성시,놀러와,680000,1800000,520000,3000000
경기 군포시,농심,2000000,0,0,2000000
경기 안성시,농협안성교육원 농업도서관,2400000,0,0,2400000
경기 부천시,누리마루작은도서관,3000000,0,1000000,4000000
경기 김포시,누리봄문고,3000000,16000000,22680000,41680000
경기 부천시,누리작은도서관,0,0,1200000,1200000
경기 군포시,누림과나눔작은도서관,380000,0,250000,630000
경기 안산시,뉴새마을도서관,10000000,69238810,19361190,98600000
경기 안양시,느린소,125000,0,0,125000
경기 안양시,느티나무,1700000,0,1320000,3020000
경기 군포시,느티나무도서관,2000000,2400000,2300000,6700000
경기 안산시,늘사랑 문고,0,0,0,0
경기 화성시,늘푸른,3600000,3600000,1300000,8500000
경기 가평군,늘푸른상상력도서관,0,0,0,0
경기 시흥시,늘푸른세종작은도서관,0,0,100000,100000
경기 여주시,늘푸른자연학교작은도서관,2500000,0,200000,2700000
경기 구리시,늘푸른작은도서관,600000,0,0,600000
경기 시흥시,늠내골실버작은도서관,1365100,0,8527560,9892660
경기 화성시,능동 주공1아파트 문고,0,0,1000000,1000000
경기 화성시,능동 주공2아파트 문고,0,0,0,0
경기 수원시,능실샘작은도서관,3400000,0,7000000,10400000
경기 시흥시,다문화작은도서관,0,0,0,0
경기 남양주시,다사랑도서관,100000,0,200000,300000
경기 평택시,다사리도서관,2000000,25000000,10000000,37000000
경기 남양주시,다산어린이도서관,0,0,0,0
경기 안산시,다솔어린이작은도서관,0,0,0,0
경기 김포시,다울누림 작은도서관,500000,0,0,500000
경기 화성시,다은 우남,7836596,0,4415370,12251966
경기 남양주시,단비작은도서관,300000,0,0,300000
경기 안양시,달안동주민센타,1000000,0,0,1000000
경기 안양시,달팽이,3000000,2400000,5000000,10400000
경기 군포시,당정동 벤티움 작은도서관,2541590,1173000,0,3714590
경기 군포시,당정문화도서관,36000000,57000000,13324330,106324330
경기 김포시,대곶작은도서관,3000000,16000000,1571050,20571050
경기 고양시,대덕 작은도서관,9865190,8618950,3515860,22000000
경기 의왕시,대명구름채아파트문고,1500000,0,0,1500000
경기 파주시,대방열린도서관,1665650,2400000,393800,4459450
경기 수원시,대영교회문고,300000,0,0,300000
경기 의왕시,대우이안아파트문고,1500000,0,0,1500000
경기 수원시,대월새마을문고,5000000,0,2400000,7400000
경기 성남시,대은작은도서관,2100000,3500000,2200000,7800000
경기 수원시,대임문고창조교실,100,0,20,120
경기 광주시,대주작은도서관,9000000,13850000,5855780,28705780
경기 수원시,대추동이 작은도서관,0,0,400000,400000
경기 평택시,대추리솔부엉이도서관,0,0,0,0
경기 광명시,대한작은어린이도서관,1500000,14400000,3600000,19500000
경기 고양시,대화마을작은도서관,9778820,20790580,10628310,41197710
경기 용인시,더빛 Ark Kids 작은도서관,1200000,0,54550000,55750000
경기 남양주시,덕소도서관,2600000,0,0,2600000
경기 남양주시,덕소현대아파트도서관,1292700,0,1200000,2492700
경기 하남시,덕풍시장작은도서관,5000000,0,5000000,10000000
경기 용인시,데시앙도서관,3600000,0,1800000,5400000
경기 남양주시,도농롯데아파트독서실,0,0,0,0
경기 광명시,도덕파크 푸른솔 작은도서관,4000000,2000000,500000,6500000
경기 의왕시,도란도란위브도서관,1000000,0,0,1000000
경기 양주시,도란도란작은도서관,0,0,2400000,2400000
경기 부천시,도란도란작은도서관,10000000,24611800,18374960,52986760
경기 동두천시,도심광장 지혜의 등대,6240000,0,3760000,10000000
경기 광주시,도척작은도서관,14000000,28163100,5369000,47532100
경기 성남시,도촌동작은도서관,4895970,33045000,6579450,44520420
경기 성남시,독수리작은도서관,2000000,0,1000000,3000000
경기 안양시,동그라미,0,0,500000,500000
경기 안산시,동동도서관,1200000,0,800000,2000000
경기 동두천시,동두천초등학교지혜의등대,4598000,20608650,6793350,32000000
경기 고양시,동산마을22단지 백송도서관,1200000,0,1200000,2400000
경기 의왕시,동아에코빌도서관,1020000,0,780000,1800000
경기 양주시,동안작은도서관,1500000,0,1200000,2700000
경기 고양시,동양아파트새마을문고,538000,0,8021060,8559060
경기 파주시,동양월드꿈나무도서관,1800000,5100000,700000,7600000
경기 이천시,동양작은도서관,4000000,5400000,3100000,12500000
경기 남양주시,동원작은도서관,5100000,0,0,5100000
경기 오산시,동인문고,0,0,0,0
경기 용인시,동천작은도서관,100000,0,6500000,6600000
경기 화성시,동탄파라곤 북카페 작은도서관,0,0,0,0
경기 군포시,동화나무어린이도서관,4000000,19208000,7528000,30736000
경기 성남시,될성푸른나무 작은도서관,2500000,0,6000000,8500000
경기 수원시,두견마을도서관,2000000,0,3600000,5600000
경기 고양시,두근두근 도서관,1200000,0,3600000,4800000
경기 평택시,두드림도서관,250000,0,300000,550000
경기 안양시,두란노,0,0,3000000,3000000
경기 화성시,두루미 작은도서관,5000000,300000,5000000,10300000
경기 화성시,두산 위브 어린이 도서관,2400000,4800000,600000,7800000
경기 화성시,두산책마을작은도서관,2885860,0,4115210,7001070
경기 의왕시,뒷동네도서관,3000000,0,5200000,8200000
경기 성남시,드림랜드작은도서관,0,0,0,0
경기 평택시,디사이플스 인문학도서관,0,0,0,0
경기 부천시,뜰안에작은나무 작은도서관,200000,20400000,2400000,23000000
경기 성남시,래미안금광작은도서관,1000000,0,4000000,5000000
경기 용인시,래미안도서관 글샘,3232160,0,4067840,7300000
경기 수원시,래미안새마을문고,5000000,0,2400000,7400000
경기 고양시,래미안휴레스트문고,2000000,1500000,0,3500000
경기 안양시,럭키,1700000,0,1320000,3020000
경기 수원시,로뎀나무문고,0,0,0,0
경기 성남시,롯데캐슬,1000000,500000,0,1500000
경기 화성시,롯데캐슬,6803650,3560000,6871150,17234800
경기 용인시,롯데캐슬에코 북카페,700000,7000000,0,7700000
경기 고양시,리슈빌도서관(세솔책방),0,3500000,200000,3700000
경기 성남시,마루아라 작은도서관,0,0,0,0
경기 용인시,마북e편한세상 작은도서관,0,0,100000,100000
경기 남양주시,마석10리 언덕위의 꿈터,0,0,0,0
경기 김포시,마송휴먼시아 10단지 작은도서관,0,0,0,0
경기 의정부시,마을도서관 나무(명칭변경),0,0,0,0
경기 남양주시,마을사립문고,0,0,0,0
경기 수원시,마중물어린이전문도서관,0,0,3000000,3000000
경기 오산시,맑은누리도서관,0,0,250000,250000
경기 광명시,맑은샘 작은도서관,2000000,20800000,1200000,24000000
경기 의정부시,맑은샘도서관,3016260,2492500,5547290,11056050
경기 구리시,맑은샘문고,500000,0,0,500000
경기 화성시,맑은샘문고,1000000,0,200000,1200000
경기 안양시,맑은책내음,0,1700000,1320000,3020000
경기 수원시,매교동새마을문고,5000000,0,2400000,7400000
경기 수원시,매산동 새마을문고,5000000,0,2400000,7400000
경기 김포시,매수리마을작은도서관,2200000,0,0,2200000
경기 수원시,매탄1동 새마을문고,5000000,0,2400000,7400000
경기 수원시,매탄2동새마을문고,5000000,0,2400000,7400000
경기 수원시,매탄3동 새마을문고,5000000,0,2400000,7400000
경기 수원시,매탄4동 새마을문고,5000000,0,2400000,7400000
경기 의왕시,매화문고,1500000,0,1200000,2700000
경기 시흥시,맹꽁이책방,2000000,0,3500000,5500000
경기 남양주시,먹갓교회문고,0,0,0,0
경기 고양시,메가박스 어린이도서관,200000,33600000,2880000,36680000
경기 수원시,메가키즈박스도서관,4899800,0,0,4899800
경기 화성시,메타하나두리 작은도서관,200000,0,100000,300000
경기 양주시,명성작은도서관,0,0,1600000,1600000
경기 여주시,명품작은도서관,0,0,0,0
경기 안양시,명학마을,3000000,16000000,4200000,23200000
경기 안산시,모두어린이작은도서관,1500000,16969435,18206022,36675457
경기 의왕시,모란문고,1050000,0,0,1050000
경기 시흥시,목감영어도서관,5700000,12000000,2400000,20100000
경기 수원시,목양작은도서관,0,0,0,0
경기 연천군,무등실작은도서관,3046000,16338480,4154000,23538480
경기 화성시,무럭무럭도서관,2298300,0,10735820,13034120
경기 화성시,무지개 작은도서관,100000,0,6500000,6600000
경기 남양주시,무지개꿈문고,5100000,0,1650000,6750000
경기 파주시,무지개도서관,1608360,0,796870,2405230
경기 오산시,무지개도서관,2000000,14171000,1200000,17371000
경기 성남시,무지개뜨는언덕작은도서관,100000,200000,60000,360000
경기 평택시,무지개작은도서관,1000000,9000000,8400000,18400000
경기 오산시,무지개작은도서관,200000,0,1200000,1400000
경기 부천시,무지개작은도서관,20000000,5471960,11825000,37296960
경기 광주시,문광마을문고,500000,0,0,500000
경기 파주시,문발리도서관,5000000,20000000,10000000,35000000
경기 과천시,문원동새마을문고,1000000,0,600000,1600000
경기 고양시,문촌7단지도서관,500000,1920000,580000,3000000
경기 성남시,물푸레 작은도서관,3300000,800000,12800000,16900000
경기 용인시,물푸레도서관,4500000,3600000,120000,8220000
경기 용인시,물푸레마을 새빛 도서관,1300000,0,1000000,2300000
경기 용인시,미라클차일드어린이영어도서관,1000000,1500000,300000,2800000
경기 부천시,미소지움작은도서관,1200000,0,500000,1700000
경기 부천시,민들레 작은도서관,1000000,10000000,1000000,12000000
경기 남양주시,민들레문고,1200000,0,960000,2160000
경기 오산시,민들레어린이도서관,0,0,0,0
경기 수원시,민들레작은도서관,500000,0,7200000,7700000
경기 시흥시,민들레작은도서관,0,0,5000000,5000000
경기 부천시,민들레홀씨작은도서관,9799980,18496800,19830130,48126910
경기 김포시,민통선도서관,0,0,0,0
경기 양주시,밀물병영작은도서관,300000,0,0,300000
경기 용인시,바른샘도서관,1200000,500000,200000,1900000
경기 수원시,바른생협바로미도서관,0,8939000,8696277,17635277
경기 안양시,박달1동 작은도서관,500000,10800000,3700000,15000000
경기 화성시,반달작은도서관,2015290,3066510,1168200,6250000
경기 용인시,반도보라빌문고,0,0,0,0
경기 김포시,반도유보라 작은도서관,1434310,6480000,762780,8677090
경기 고양시,반디 작은도서관,2000000,1452000,8879000,12331000
경기 화성시,반딧불 작은도서관(팔탄),2603270,3500000,2481730,8585000
경기 화성시,반딧불 작은도서관(향남),0,0,0,0
경기 고양시,반딧불도서관,2400000,3600000,2160000,8160000
경기 용인시,반딧불이도서관,100000,150000,200000,450000
경기 양주시,반딧불이작은도서관,0,0,5400000,5400000
경기 시흥시,반석도서관,300000,300000,400000,1000000
경기 화성시,반올림 작은도서관,6520590,5040000,0,11560590
경기 안산시,반월햇빛작은도서관,16000000,8640000,21491000,46131000
경기 화성시,발안마을주공,1200000,4800000,0,6000000
경기 광명시,밝은빛 음악 영어 작은도서관,2000000,6000000,2400000,10400000
경기 광명시,밝은빛 작은도서관,3200000,47355000,50908600,101463600
경기 수원시,밤밭새마을문고,5000000,0,2400000,7400000
경기 용인시,밤토실어린이작은도서관,1500000,0,2900000,4400000
경기 군포시,밥상머리북카페,15073340,49487470,8204300,72765110
경기 고양시,배움과 나눔작은도서관,0,0,0,0
경기 용인시,백남준 라이브러리,5500000,23940000,9066000,38506000
경기 고양시,백마작은도서관,13598590,0,819920,14418510
경기 이천시,백사작은도서관,3500000,4800000,1200000,9500000
경기 양주시,백석한승작은도서관,0,0,3220000,3220000
경기 용인시,백암면 작은도서관,1500000,0,5640000,7140000
경기 고양시,백합 작은도서관,6000000,0,1000000,7000000
경기 의왕시,백합아파트문고,1900000,0,0,1900000
경기 용인시,버들치도서관,1124340,0,1275660,2400000
경기 부천시,범박휴먼시아2단지 작은도서관,0,1800000,1800000,3600000
경기 고양시,벧엘문고,0,0,0,0
경기 안양시,벽산,500000,0,2000000,2500000
경기 용인시,벽산도서관,1231150,2070000,0,3301150
경기 남양주시,별가람작은도서관 ,0,0,0,0
경기 남양주시,별내리슈빌작은도서관 ,0,0,0,0
경기 남양주시,별내칸타빌작은도서관 ,2000000,0,500000,2500000
경기 가평군,별빛도서관,0,0,0,0
경기 과천시,별양4단지 새마을문고,1000000,0,600000,1600000
경기 과천시,별양6단지새마을문고,1000000,0,600000,1600000
경기 광주시,보들리안도서관,3000000,0,6000000,9000000
경기 안산시,보라매어린이작은도서관,600000,4800000,400000,5800000
경기 안양시,보라미 작은도서관(교도소),1120000,0,0,1120000
경기 성남시,보람무지개작은도서관,1000000,2400000,5600000,9000000
경기 김포시,보름산 미술관 작은도서관,0,0,0,0
경기 부천시,보물단지작은도서관,5000000,32700000,19000000,56700000
경기 안양시,보물창고,1700000,0,1320000,3020000
경기 시흥시,보성아파트 희망도서실,0,0,0,0
경기 시흥시,복된교회문고,0,0,0,0
경기 부천시,복된교회작은도서관,1000000,0,0,1000000
경기 부천시,복사꽃필무렵작은도서관,10000000,21783140,21795000,53578140
경기 양주시,복지작은도서관,0,0,0,0
경기 안산시,본오1동작은도서관,20000000,43510000,48004000,111514000
경기 안산시,본오3동 장수작은도서관,7000000,0,12590000,19590000
경기 안산시,본오책누리도서관,0,0,20400000,20400000
경기 파주시,봄싹도서관,3600000,7200000,4800000,15600000
경기 화성시,봉담아이파크도서관,1000000,1200000,100000,2300000
경기 양주시,봉암작은도서관,10000000,28570000,28232000,66802000
경기 양주시,봉우작은도서관,0,0,1200000,1200000
경기 파주시,봉일천등용도서관,18203370,21230770,528650,39962790
경기 의왕시,부곡글고운도서관,11300000,57000000,2100000,70400000
경기 수원시,부광복지문고,400000,0,1350000,1750000
경기 안성시,부영도서관,7000000,20682380,6700400,34382780
경기 부천시,부천비전 작은도서관,1200000,14400000,7400000,23000000
경기 안양시,부흥동주민센타,1000000,0,0,1000000
경기 여주시,북내작은도서관,0,0,0,0
경기 남양주시,북스토리,2400000,0,0,2400000
경기 광명시,북스토리 작은도서관,4400000,3600000,3710000,11710000
경기 오산시,북카페 토기장이의 집,0,0,0,0
경기 성남시,분당구미어린이 작은도서관,14400000,0,0,14400000
경기 고양시,불교명상 도서관,0,0,1200000,1200000
경기 의정부시,브라운스톤흥선도서관,1269380,7555900,3925440,12750720
경기 고양시,블루밍도서관,6040000,6600000,2500000,15140000
경기 고양시,블루밍독서의집 새마을문고,0,5076400,0,5076400
경기 안양시,비산3동 주민센터,1000000,10800000,4200000,16000000
경기 이천시,비승병영도서관,0,0,0,0
경기 하남시,비전 작은도서관,2300000,0,7400000,9700000
경기 시흥시,비전나무작은도서관,600000,0,3600000,4200000
경기 고양시,비전도서관,1400000,3600000,6000000,11000000
경기 평택시,비전작은도서관,40000000,27008640,20000000,87008640
경기 이천시,비전작은도서관,1200000,0,600000,1800000
경기 파주시,비전眞작은도서관,300000,0,5850000,6150000
경기 양주시,빛과소금작은도서관,200000,0,1000000,1200000
경기 파주시,빛나요 작은도서관,300000,0,2100000,2400000
경기 화성시,쁘레네 작은도서관 별찌,4000000,4200000,12000000,20200000
경기 고양시,쁘레네 작은도서관 별찌,2040500,2400000,2106410,6546910
경기 광주시,쁘레네 작은도서관 별찌,0,4500000,14339310,18839310
경기 용인시,쁘레네 작은도서관 별찌,3000000,5000000,12000000,20000000
경기 군포시,쁘레네 작은도서관 별찌,1300000,6600000,7200000,15100000
경기 수원시,쁘레네 작은도서관 별찌,1000000,5000000,8000000,14000000
경기 성남시,쁘레네별찌(정자)작은도서관,2460000,8400000,1340000,12200000
경기 성남시,쁘레네별찌(판교)작은도서관,2000000,500000,1560000,4060000
경기 이천시,쁘레네작은도서관,2350000,2400000,12000000,16750000
경기 안산시,사3동작은도서관,7000000,0,5630000,12630000
경기 안양시,사과나무꿈동산어린이,4000000,0,3000000,7000000
경기 과천시,사과나무도서관,2400000,6000000,12000000,20400000
경기 이천시,사동누리작은도서관,3500000,4800000,2400000,10700000
경기 동두천시,사동초등학교 도서관,3363000,21655000,6982000,32000000
경기 고양시,사랑나눔 도서관,3960000,0,1040000,5000000
경기 부천시,사랑나무가족도서관,10000000,20038200,19868060,49906260
경기 평택시,사랑나무작은도서관,2000000,6000000,20000000,28000000
경기 부천시,사랑샘작은도서관,0,0,0,0
경기 하남시,사랑영어작은도서관,500000,0,500000,1000000
경기 고양시,사랑의 샘,0,0,2400000,2400000
경기 군포시,사랑이있는작은도서관,699980,2180200,8119820,11000000
경기 양주시,사랑작은도서관,2000000,0,100000,2100000
경기 여주시,사랑작은도서관,0,0,0,0
경기 고양시,사리현 작은도서관,10745200,20660130,9794670,41200000
경기 광명시,사성 작은도서관,3000000,1800000,0,4800000
경기 수원시,사이좋은도서관,0,0,2000000,2000000
경기 안성시,사자숲작은도서관,200000,400000,6000000,6600000
경기 파주시,산들바람 작은도서관,1200000,0,1200000,2400000
경기 군포시,산본역도서관,0,10000000,5000000,15000000
경기 여주시,산북작은도서관,9268650,40725080,32833660,82827390
경기 양주시,산북작은도서관,1500000,0,2200000,3700000
경기 의정부시,산악도서관,1134300,0,829000,1963300
경기 안양시,산오름어린이,6500000,12000000,17000000,35500000
경기 김포시,살렘작은도서관,0,0,0,0
경기 시흥시,삼립식품작은도서관,0,16230000,0,16230000
경기 안양시,삼막골,0,0,1000000,1000000
경기 오산시,삼미마을 19단지 지혜관,600000,0,1200000,1800000
경기 부천시,삼성래미안 작은도서관,0,0,1440000,1440000
경기 군포시,삼성마을 5단지 작은도서관,2500000,9500000,4700000,16700000
경기 수원시,삼성알밤문고,1800000,0,0,1800000
경기 안성시,삼죽도서관,29337000,19888430,4865080,54090510
경기 과천시,삼포새마을문고,1000000,0,600000,1600000
경기 용인시,삼풍동작은도서관,3000000,2500000,500000,6000000
경기 성남시,상대원3동작은도서관,3000000,26575000,2160000,31735000
경기 화성시,상동비전 작은도서관,0,0,0,0
경기 부천시,상동역칙칙폭폭도서관,111500,29271000,3646000,33028500
경기 화성시,상록문고,5496000,0,4931760,10427760
경기 안산시,상록브니엘문고,0,0,0,0
경기 연천군,상리작은도서관,3121500,14261830,6278500,23661830
경기 평택시,상상도서관,3600000,2520000,1880000,8000000
경기 수원시,상송마을주공작은도서관,1200000,0,0,1200000
경기 용인시,상현1동 작은도서관,6000000,9750000,1800000,17550000
경기 화성시,새강꿈터도서관,0,0,50000,50000
경기 화성시,새강마을 작은도서관,3000000,0,3000000,6000000
경기 광명시,새나래 작은도서관,649330,4000000,840000,5489330
경기 안양시,새날,0,0,0,0
경기 안산시,새마을문고 수정작은도서관,0,0,6000000,6000000
경기 안성시,새마을문고센터,0,0,0,0
경기 부천시,새마을문고중앙회부천시지부,0,0,27960000,27960000
경기 과천시,새마을중앙동문고,1000000,0,600000,1600000
경기 남양주시,새싹작은도서관,5100000,0,0,5100000
경기 양주시,새싹작은도서관,1200000,0,3960000,5160000
경기 안양시,새안양,0,0,0,0
경기 고양시,새하늘작은도서관,0,0,0,0
경기 여주시,새하늘작은도서관,3399000,0,1601000,5000000
경기 시흥시,새희망교회,0,0,3000000,3000000
경기 안산시,새희망작은도서관,500000,0,3500000,4000000
경기 시흥시,새희망작은도서관,0,0,0,0
경기 화성시,샘내작은도서관,15000000,40000000,42764000,97764000
경기 수원시,샘물도서관,2000000,1000000,2000000,5000000
경기 성남시,샘물어린이 작은도서관,600000,8400000,1000000,10000000
경기 군포시,샘물작은도서관,0,100000,0,100000
경기 이천시,샘터작은도서관,3000000,4800000,3000000,10800000
경기 남양주시,샘터작은도서관,500000,0,1000000,1500000
경기 화성시,생각마루,2576150,5900000,95000,8571150
경기 김포시,생각샘도서관,1000000,6000000,200000,7200000
경기 부천시,생글생글 작은도서관,0,0,7200000,7200000
경기 수원시,생활연극작은도서관,1800000,0,5400000,7200000
경기 군포시,샤론작은도서관,3000000,6000000,3000000,12000000
경기 성남시,샤인작은도서관,500000,12000000,13250000,25750000
경기 안산시,샬롬문고,0,9600000,4200000,13800000
경기 용인시,서농동 작은도서관,0,0,0,0
경기 수원시,서둔동새마을문고,5000000,0,2400000,7400000
경기 성남시,서라운드작은도서관,1000000,4800000,1200000,7000000
경기 수원시,서수원자이 어린이 문고,3000000,0,0,3000000
경기 고양시,서정 글 쉼터 도서관,1200000,0,2040000,3240000
경기 평택시,서정작은도서관,40000000,37463360,16557000,94020360
경기 양평군,서종작은도서관,1077400,15630000,4338040,21045440
경기 파주시,서축공업작은도서관,1960898,34194000,0,36154898
경기 화성시,서해 백일홍 북카페,5336290,13262400,7660562,26259252
경기 화성시,서해더블루LUX 작은도서관,0,0,6000000,6000000
경기 성남시,서현청소년작은도서관,3766510,17556000,2970890,24293400
경기 안양시,석수1동 작은도서관,1000000,0,0,1000000
경기 안양시,석수2동 작은도서관,999080,2455000,0,3454080
경기 안양시,석수3동 작은도서관,0,10800000,3956371,14756371
경기 안산시,석수골작은도서관,15000000,44313520,25911304,85224824
경기 이천시,선경도서실,0,0,0,0
경기 안산시,선녀마을작은도서관,10000000,21567000,23832000,55399000
경기 포천시,선단동어린이작은도서관,0,0,0,0
경기 포천시,선단작은도서관,5673350,9860000,1876650,17410000
경기 성남시,섬마을 5단지 작은도서관,0,0,1200000,1200000
경기 평택시,성광작은도서관,2000000,0,200000,2200000
경기 파주시,성원도서실,0,0,0,0
경기 양주시,성은작은도서관,1200000,0,1200000,2400000
경기 용인시,성지작은도서관,1142545,0,630000,1772545
경기 부천시,성진어린이작은도서관,449870,233500,878190,1561560
경기 성남시,성현작은도서관,0,0,0,0
경기 수원시,세류1동새마을문고,5000000,0,2400000,7400000
경기 수원시,세류2동 새마을문고,5000000,0,2400000,7400000
경기 수원시,세류3동새마을문고,5000000,0,2400000,7400000
경기 오산시,세마고도서관,13000000,25500000,5227000,43727000
경기 광명시,세븐 작은도서관,1200000,0,600000,1800000
경기 양주시,세아작은도서관,0,0,1600000,1600000
경기 남양주시,세우는도서관,0,0,0,0
경기 광명시,세움 작은도서관,1400000,3000000,23000000,27400000
경기 화성시,센트럴 북카페 작은도서관 ,4900000,11500000,1200000,17600000
경기 화성시,센트럴파크작은도서관,0,0,0,0
경기 부천시,소나무푸른작은도서관,9800000,21813900,10751000,42364900
경기 평택시,소망작은도서관,0,0,1000,1000
경기 부천시,소사영어작은도서관,10000000,10000000,10000000,30000000
경기 부천시,소새울가족도서관,9760000,21813900,17634000,49207900
경기 수원시,소성도서관,0,0,0,0
경기 용인시,소소한작은행복도서관,700000,0,6300000,7000000
경기 구리시,소월독서문화원,3000000,13200000,6540000,22740000
경기 광명시,소하1동 작은도서관,1600000,0,800000,2400000
경기 의왕시,솔거아파트문고,1050000,0,0,1050000
경기 김포시,솔래작은도서관,0,0,0,0
경기 여주시,솔로몬작은도서관,0,0,0,0
경기 가평군,솔빛도서관,0,0,0,0
경기 성남시,솔샘 작은도서관,1922410,0,7077590,9000000
경기 부천시,솔안마을작은도서관,2000000,0,6000000,8000000
경기 수원시,솔지 아동 영재 작은도서관,0,13200000,740000,13940000
경기 김포시,솔터2단지작은도서관,0,165000,0,165000
경기 김포시,솔터마을3단지 작은도서관,0,2060060,1108400,3168460
경기 화성시,송골우남작은도서관,2395370,3600000,2285670,8281040
경기 부천시,송내 작은도서관,2000000,0,10000000,12000000
경기 부천시,송내자이작은도서관,0,480000,70000,550000
경기 의정부시,송산1동작은도서관,6000000,13800000,1992857,21792857
경기 의정부시,송산2동작은도서관,7200000,13800000,1992857,22992857
경기 안성시,송정도서관,7000000,38836310,8448830,54285140
경기 수원시,송죽동새마을문고,5000000,0,2400000,7400000
경기 평택시,송탄작은도서관,40000000,27000000,20000000,87000000
경기 안성시,송호문고,2000000,2400000,1200000,5600000
경기 파주시,쇠재작은도서관,4374380,2800000,7957640,15132020
경기 성남시,수내1동작은도서관,3000000,28000000,1000000,32000000
경기 고양시,수냐의 수학도서관,1000000,0,1800000,2800000
경기 남양주시,수동작은도서관,7200000,43600000,2000000,52800000
경기 의정부시,수락글방,1196090,5838200,1662970,8697260
경기 수원시,수원 다문화 도서관 지구별상상,0,0,28360000,28360000
경기 수원시,수원교회문고,1000000,0,600000,1600000
경기 수원시,수정도서관,0,0,0,0
경기 성남시,수정중앙작은도서관,210000,0,90000,300000
경기 성남시,수진2동작은도서관,35000000,17156520,5700000,57856520
경기 구리시,수택1동작은도서관,5621600,33472220,5856000,44949820
경기 구리시,수택작은도서관,5609800,39502620,6000000,51112420
경기 안양시,순종,4200000,6000000,6000000,16200000
경기 파주시,술이홀도서관,6250000,13185000,6815000,26250000
경기 연천군,숨마을작은도서관,1200000,2400000,3600000,7200000
경기 의왕시,숲도서관,600000,0,1800000,2400000
경기 부천시,숲속 작은도서관,21100000,34337000,6046000,61483000
경기 용인시,숲속도서관,30000000,0,0,30000000
경기 화성시,숲속모아 작은도서관,2351790,6000000,2648210,11000000
경기 화성시,숲속문고,2594280,3600000,3658240,9852520
경기 의왕시,숲속옹달샘도서관,2000000,110000,0,2110000
경기 양주시,숲속작은도서관,500000,0,4000000,4500000
경기 성남시,숲속작은도서관,1400000,0,5250000,6650000
경기 의왕시,숲속책마을,1050000,0,0,1050000
경기 김포시,쉴만한 물가,0,0,0,0
경기 고양시,쉴만한 물가,500000,0,1500000,2000000
경기 용인시,스프라웃도서관,1000000,14400000,12000000,27400000
경기 구리시,스프링작은도서관,1200000,2400000,4800000,8400000
경기 이천시,시온성문고,2400000,0,0,2400000
경기 부천시,시온열린작은도서관,9800000,26953740,21422690,58176430
경기 시흥시,시흥6차 푸르지오 2단지 푸른도서관,1200000,0,1200000,2400000
경기 성남시,시흥동작은도서관,0,0,0,0
경기 시흥시,시흥새마을작은도서관,0,18910000,12070000,30980000
경기 시흥시,시흥시발달장애인작은도서관,0,0,0,0
경기 의정부시,신곡1동작은도서관,7200000,13800000,1992857,22992857
경기 의정부시,신곡2동작은도서관,7200000,13800000,1992857,22992857
경기 부천시,신광작은도서관,0,0,3000000,3000000
경기 안산시,신길샛별작은도서관,15000000,45740753,21830050,82570803
경기 부천시,신나는가족도서관,10000000,20110800,17072080,47182880
경기 의정부시,신도브래뉴PLUS,956625,990000,663710,2610335
경기 고양시,신도작은도서관,12000000,20994000,7006000,40000000
경기 남양주시,신마석 신도숲속북카페,7800000,0,2588800,10388800
경기 수원시,신명새마을문고,5000000,0,2400000,7400000
경기 성남시,신미주 작은도서관,1200000,100000,5000000,6300000
경기 용인시,신봉우남아파트도서관,1500000,0,1500000,3000000
경기 포천시,신북작은도서관,3128600,11298000,4421400,18848000
경기 의왕시,신안문고,1300000,0,0,1300000
경기 용인시,신영지웰작은도서관,3000000,0,1800000,4800000
경기 양주시,신우작은도서관,0,0,3000000,3000000
경기 고양시,신원글마루 도서관,0,0,0,0
경기 의왕시,신원수선화아파트문고,1050000,0,0,1050000
경기 화성시,신일 유토빌 책마을,5131180,3940000,2699410,11770590
경기 화성시,신일해피트리2차(아)문고,0,720000,0,720000
경기 평택시,신장작은도서관,150000,400000,600000,1150000
경기 화성시,신창2차 책마을,3600000,0,2400000,6000000
경기 화성시,신창미션힐1차아파트 작은도서관,1874450,4200000,211100,6285550
경기 포천시,신평장자작은도서관,0,0,0,0
경기 성남시,신흥1동작은도서관,10000000,69781000,17165000,96946000
경기 성남시,신흥3동작은도서관,1000000,0,0,1000000
경기 성남시,신흥작은도서관,1000000,1000000,1000000,3000000
경기 남양주시,실학박물관도서관,0,0,0,0
경기 화성시,쌍용예가책마을도서관,400000,400000,100000,900000
경기 부천시,써미트빌작은도서관,0,0,0,0
경기 수원시,쏙쏙꾸러기 작은도서관,1000000,0,1000000,2000000
경기 양주시,쓰임작은도서관,300000,0,0,300000
경기 남양주시,아가페도서관,0,0,0,0
경기 하남시,아낌없이주는나무작은도서관,3051350,4006000,600310,7657660
경기 용인시,아델리움글마루도서관,2400000,0,3600000,6000000
경기 수원시,아람작은도서관,150000,0,150000,300000
경기 의정부시,아람터도서관,1500000,12000000,5761248,19261248
경기 성남시,아름널작은도서관,3869940,2900000,8020990,14790930
경기 용인시,아름다운꿈의도서관,500000,0,3000000,3500000
경기 남양주시,아름다운문고,0,0,0,0
경기 양주시,아름다운작은도서관,1000000,0,1200000,2200000
경기 화성시,아름드리,1500000,6000000,1200000,8700000
경기 성남시,아름드리 작은도서관,0,0,703880,703880
경기 부천시,아름드리도서관,10000000,21813900,19760760,51574660
경기 이천시,아리마을작은도서관,8000000,10250000,1200000,19450000
경기 화성시,아삭 작은도서관,2320000,600000,15000000,17920000
경기 고양시,아시아의 친구들,0,0,0,0
경기 남양주시,아이뜰작은도서관,0,0,0,0
경기 성남시,아튼빌 작은도서관,367150,6000000,3674740,10041890
경기 의정부시,안말사랑도서관,2012600,400000,587400,3000000
경기 안산시,안산다문화작은도서관,16000000,36000000,0,52000000
경기 안산시,안산동믿음작은도서관,0,0,0,0
경기 안산시,안산열린교실소나무작은도서관,0,0,0,0
경기 안산시,안산열린교실우리들문고,0,0,0,0
경기 안산시,안산영광작은도서관,0,0,0,0
경기 안산시,안산우리작은도서관,0,0,1200000,1200000
경기 안산시,안산자유작은도서관,3000000,19200000,9600000,31800000
경기 안산시,안산중앙작은도서관행복도서관,0,0,0,0
경기 안산시,안산평생학습관작은도서관,0,22000000,25100000,47100000
경기 안양시,안양1동 작은도서관,1000000,0,0,1000000
경기 안양시,안양3동 작은도서관,6000000,10800000,4200000,21000000
경기 안양시,안양4동 작은도서관,1000000,0,0,1000000
경기 안양시,안양5동 작은도서관,0,10800000,4200000,15000000
경기 안양시,안양7동 작은도서관,0,0,0,0
경기 안양시,안양9동 작은도서관,1000000,0,0,1000000
경기 안양시,안양주민문고,0,0,0,0
경기 여주시,알곡작은도서관,0,0,0,0
경기 구리시,애기똥풀 도서관,3000000,21000000,15000000,39000000
경기 용인시,애벌레도서관,2000000,0,2000000,4000000
경기 성남시,야탑1동작은도서관,3000000,28863000,1000000,32863000
경기 여주시,양귀리작은도서관,0,0,2500000,2500000
경기 오산시,양산영어도서관,2500000,0,0,2500000
경기 양주시,양주경찰서 작은도서관,0,0,0,0
경기 양주시,양주한승작은도서관,1200000,0,2400000,3600000
경기 성남시,양지동 작은도서관,2000000,0,0,2000000
경기 용인시,양지마을문고,0,0,300000,300000
경기 안산시,어린이도서관책날개,500000,500000,500000,1500000
경기 성남시,어울림 작은도서관,250000,0,2400000,2650000
경기 남양주시,어울림도서관(오남),0,0,5400000,5400000
경기 남양주시,어울림도서관(평내),0,0,0,0
경기 수원시,에덴작은도서관,2000000,8000000,6600000,16600000
경기 이천시,에버빌작은도서관,3500000,4800000,3600000,11900000
경기 의왕시,에버하임도서관,0,11253530,1720130,12973660
경기 안성시,엘리트도서관,0,0,0,0
경기 남양주시,엘림 작은도서관,0,0,0,0
경기 군포시,여담작은도서관,3000000,0,9273000,12273000
경기 부천시,여월5단지 작은도서관,0,0,1000000,1000000
경기 부천시,여월휴먼시아 작은도서관,4000000,1800000,4100000,9900000
경기 여주시,여주 남한강문고,0,0,0,0
경기 여주시,여주부영아파트작은도서관,7500000,0,12488450,19988450
경기 부천시,역곡역e편한세상 작은도서관,0,2760000,0,2760000
경기 성남시,연꽃마을작은도서관,2000000,13500000,3500000,19000000
경기 수원시,연무동 새마을문고,5000000,0,2400000,7400000
경기 안양시,연현마을두산위브,1700000,0,1320000,3020000
경기 화성시,열리는 비전 작은도서관,2135800,6250000,12112400,20498200
경기 부천시,열린 작은도서관,2000000,18000000,15500000,35500000
경기 남양주시,열린도서관,0,0,0,0
경기 오산시,열린도서관,2000000,14171000,1200000,17371000
경기 안양시,열린문고,0,0,0,0
경기 오산시,열린비전도서관,500000,0,1000000,1500000
경기 안양시,열린초원,1700000,0,1320000,3020000
경기 수원시,열림도서관,0,0,0,0
경기 부천시,염광작은도서관,2500000,0,1200000,3700000
경기 용인시,영덕신일문고,1200000,2400000,2400000,6000000
경기 성남시,영도 작은도서관,1000000,7200000,2000000,10200000
경기 용인시,영락도서관,200000,0,0,200000
경기 의정부시,영유아미래도서관,97200,11738500,1982400,13818100
경기 수원시,영통1동 새마을문고,5000000,0,2400000,7400000
경기 수원시,영통2동 새마을문고,5000000,0,2400000,7400000
경기 수원시,영화동새마을문고,5000000,0,2400000,7400000
경기 용인시,영화작은도서관,1463000,6319450,37000,7819450
경기 김포시,예가 작은도서관,1200000,8436960,0,9636960
경기 부천시,예그필작은도서관,100000,0,1000000,1100000
경기 광주시,예꿈비전스쿨 작은도서관,12000000,1000000,1000000,14000000
경기 성남시,예꿈작은도서관,3000000,4000000,25000000,32000000
경기 고양시,예다움도서관,3000000,0,1800000,4800000
경기 남양주시,예닮도서관,0,0,0,0
경기 안양시,예닮터,0,0,0,0
경기 고양시,예담도서관,500000,0,0,500000
경기 파주시,예뜨락북까페,0,0,0,0
경기 안산시,예빛작은도서관,1000000,0,4000000,5000000
경기 화성시,예사랑도서관,3000000,0,5000000,8000000
경기 고양시,예성문고,0,0,0,0
경기 화성시,예찬 작은도서관,1000000,0,1000000,2000000
경기 화성시,예촌문고,1000000,0,500000,1500000
경기 화성시,예향드림 작은도서관,3000000,0,1000000,4000000
경기 수원시,오동나무도서관,0,0,0,0
경기 구리시,오렌지문고,1085040,3600000,0,4685040
경기 화성시,오목눈이,2000000,13440000,8250000,23690000
경기 오산시,오산 사랑의문고,0,0,0,0
경기 시흥시,오이도작은도서관,544600,15432000,5198570,21175170
경기 의왕시,오전빛고운도서관,11300000,35000000,2100000,48400000
경기 부천시,오정작은도서관,620000,9800000,280000,10700000
경기 부천시,오정휴먼시아3단지작은도서관,0,0,0,0
경기 광주시,오포작은도서관,9000000,14560500,4303810,27864310
경기 시흥시,옥구공원 숲속작은도서관,1000000,0,2000000,3000000
경기 고양시,옥빛 작은 행복도서관,2000000,0,400000,2400000
경기 부천시,온가족작은도서관,0,0,1354000,1354000
경기 안양시,온마을book,0,0,0,0
경기 화성시,온사랑 작은도서관 ,2000000,0,8000000,10000000
경기 안양시,온새미로,3000000,0,1320000,4320000
경기 남양주시,온세어린이도서관,0,0,0,0
경기 수원시,온수골주민문고,0,0,0,0
경기 파주시,옹기종기작은도서관,5400000,2300000,2362286,10062286
경기 남양주시,옹달샘문고,0,0,0,0
경기 부천시,옹달샘작은도서관,0,0,0,0
경기 양주시,옹달샘작은도서관,0,0,2400000,2400000
경기 안산시,용신작은도서관,0,0,0,0
경기 용인시,용인시 사랑의 집 작은도서관,0,0,99000,99000
경기 용인시,용인영어도서관,3000000,30000000,18000000,51000000
경기 오산시,우남 퍼스트빌문고,0,3600000,0,3600000
경기 파주시,우리동네 작은도서관,0,0,0,0
경기 시흥시,우리동네작은도서관,0,0,7760000,7760000
경기 파주시,우리들의 작은도서관,0,200000,0,200000
경기 군포시,우리마을 도서관,1500000,800000,11403743,13703743
경기 시흥시,우리마을 작은도서관(도창복지문화센터),0,0,0,0
경기 광주시,우리소망문고,0,0,0,0
경기 용인시,우리작은도서관,0,0,0,0
경기 오산시,우리작은도서관,1439680,0,1880490,3320170
경기 화성시,우림필유타운하우스,6500000,4200000,2528450,13228450
경기 수원시,우만1동새마을문고,5000000,0,2400000,7400000
경기 수원시,우만2동새마을문고,5000000,0,2400000,7400000
경기 양주시,우미린어린이작은도서관,400000,0,3200000,3600000
경기 오산시,운암1단지작은도서관,0,0,0,0
경기 성남시,웃는책작은도서관,0,0,10000000,10000000
경기 안산시,원곡벽산블루밍문고,0,0,0,0
경기 부천시,원더풀 작은도서관,0,0,0,0
경기 오산시,원동청소년공부방,0,0,0,0
경기 용인시,원삼면 작은도서관,0,0,0,0
경기 남양주시,원일꿈나무작은도서관,500000,0,800000,1300000
경기 수원시,원천동 새마을 문고,5000000,0,2400000,7400000
경기 김포시,월드 작은도서관,1000000,0,0,1000000
경기 광명시,월드메르디앙 작은도서관,1000000,360000,0,1360000
경기 화성시,월드반도1차아파트문고,14362110,0,4543550,18905660
경기 화성시,월드반도2차문고,0,0,0,0
경기 시흥시,월드작은아파트(월드아파트),0,0,500000,500000
경기 파주시,월롱작은도서관,6252360,13149380,6849220,26250960
경기 양주시,유니콘병영작은도서관,300000,0,300000,600000
경기 파주시,유승한내들도서관,0,2400000,300000,2700000
경기 군포시,율곡마을작은도서관,4150390,800000,1451620,6402010
경기 이천시,율면작은도서관,3000000,4800000,1200000,9000000
경기 안양시,율목 ,6600000,0,0,6600000
경기 수원시,율전삼성새마을문고,5000000,0,2400000,7400000
경기 수원시,율천동 새마을문고,5000000,0,2400000,7400000
경기 이천시,은광문고,2000000,0,1000000,3000000
경기 양주시,은동작은도서관,3000000,0,1200000,4200000
경기 화성시,은성도서관,0,2400000,3000000,5400000
경기 시흥시,은행골작은도서관,0,0,5000000,5000000
경기 성남시,은행책마루작은도서관,0,600000,1400000,2000000
경기 의왕시,은혜문화도서관,0,0,0,0
경기 의정부시,의정부1동공립작은도서관,7200000,13800000,1992857,22992857
경기 의정부시,의정부2동작은도서관,2000000,13800000,1992857,17792857
경기 의정부시,의정부3동작은도서관,7200000,13800000,1992857,22992857
경기 용인시,이던책나무도서관,360,0,360,720
경기 용인시,이동면 작은도서관,1500000,0,3188680,4688680
경기 용인시,이동면 천리 작은도서관,1500000,0,4363340,5863340
경기 포천시,이동작은도서관,3367920,13146000,6182080,22696000
경기 구리시,이레작은도서관,0,0,0,0
경기 남양주시,이삭어린이도서관,0,0,0,0
경기 광명시,이솝 작은도서관,4000000,0,4450000,8450000
경기 안양시,이야기,0,0,0,0
경기 안산시,이야기숲어린이도서관,2000000,17700000,2000000,21700000
경기 시흥시,이야기숲작은도서관(목감지역아동센터),0,0,0,0
경기 의왕시,이음도서관,400,0,240,640
경기 김포시,이지더원작은도서관,1200000,3000000,0,4200000
경기 성남시,이지더원작은도서관,3000000,2500000,7000000,12500000
경기 평택시,이충작은도서관,3000000,1200000,2400000,6600000
경기 의왕시,이화문고,2500000,0,800000,3300000
경기 이천시,이화작은도서관,3650000,4800000,3700000,12150000
경기 수원시,인계동새마을문고,5000000,0,2400000,7400000
경기 남양주시,인스빌작은도서관,2200000,5000000,4087000,11287000
경기 구리시,인창동작은도서관,5621000,50208330,4200000,60029330
경기 안산시,일동작은도서관,32000000,50061900,214615000,296676900
경기 고양시,일산두산위브더제니스 가족도서관,2700000,14000000,4500000,21200000
경기 고양시,일산북카페(라임북카페),2225910,0,719226,2945136
경기 고양시,일산아이파크5단지 도서관,200000,0,2200000,2400000
경기 안성시,일죽도서관,28864000,35957860,7725730,72547590
경기 안양시,임곡그린빌수푸루지,8702665,0,3097335,11800000
경기 수원시,입북동새마을문고,5000000,0,2400000,7400000
경기 의정부시,자금동작은도서관,7200000,13800000,1992857,22992857
경기 광주시,자람 작은도서관,200000,0,1000000,1200000
경기 용인시,자연&Book 작은도서관,4000000,0,4800000,8800000
경기 남양주시,자연앤어울림작은도서관,3000000,4235730,4500000,11735730
경기 고양시,자유청소년도서관,1000000,0,9000000,10000000
경기 성남시,자이 작은도서관,0,3100000,1503780,4603780
경기 양주시,자이초록작은도서관,1885000,0,5000000,6885000
경기 용인시,자이행복한도서관,2500000,0,2940000,5440000
경기 평택시,작은나무 어린이도서관,1000000,0,2000000,3000000
경기 용인시,작은나무도서관,0,0,600000,600000
경기 파주시,작은도서관 '평화를 품은집 평화도서관',6500000,38400000,22000000,66900000
경기 안산시,작은도서관 모락모락,2000000,0,3600000,5600000
경기 군포시,작은도서관 버드나무에 부는바람,600000,9600000,19018800,29218800
경기 군포시,작은도서관 북카페사랑아이엔지,3200000,6000000,17600000,26800000
경기 동두천시,작은도서관 지혜의 등대,1724000,0,8276000,10000000
경기 파주시,작은도서관 한빛꿈,1200000,480000,2920000,4600000
경기 고양시,작은도서관참터문고,0,0,1800000,1800000
경기 오산시,잔다리도서관,0,0,0,0
경기 성남시,잘되는작은도서관,4900600,0,12216650,17117250
경기 김포시,장기어린이작은도서관,0,3600000,1200000,4800000
경기 평택시,장당마을도서관,6000000,400000,7600000,14000000
경기 용인시,장미도서관,4300000,0,8700000,13000000
경기 의정부시,장암동작은도서관,7200000,13800000,1992857,22992857
경기 양주시,장흥작은도서관,20000000,11052000,65502000,96554000
경기 군포시,재궁꿈나무도서관,5298000,4800000,7000000,17098000
경기 고양시,재미있는느티나무온가족 도서관,2873500,15600000,28584409,47057909
경기 안산시,재활복지작은도서관,600000,2400000,3000000,6000000
경기 용인시,전대중앙도서관,600000,0,0,600000
경기 화성시,전승병영도서관,0,0,0,0
경기 김포시,전원 작은도서관,0,688680,44280,732960
경기 의정부시,점진도서관,533800,3749285,824795,5107880
경기 수원시,정2새마을문고,5000000,0,2400000,7400000
경기 시흥시,정왕영어작은도서관,2400000,54000000,1200000,57600000
경기 수원시,정자1동새마을문고,5000000,0,2400000,7400000
경기 수원시,정자2동 새마을문고,5000000,0,2400000,7400000
경기 수원시,정자3동 그린빌 새마을문고,5000000,0,2400000,7400000
경기 성남시,정자역작은도서관,5620500,22560000,7880600,36061100
경기 성남시,정자청소년수련관작은도서관,3057520,35099350,1226300,39383170
경기 양주시,정진작은도서관,1200000,0,3600000,4800000
경기 화성시,제부도모세마을 작은도서관,1500000,5000000,500000,7000000
경기 김포시,제일도서관,0,0,200000,200000
경기 김포시,제일풍경채 작은도서관,1200000,5168320,464000,6832320
경기 남양주시,조안씨앗도서관,7200000,14400000,0,21600000
경기 수원시,조원1동 새마을문고,5000000,0,2400000,7400000
경기 수원시,조원2동새마을문고,5000000,0,2400000,7400000
경기 수원시,조원동주민문고,0,0,0,0
경기 수원시,종려나무도서관,0,0,0,0
경기 남양주시,좋은교회좋은도서관,5100000,0,0,5100000
경기 부천시,좋은나무 작은도서관,0,0,0,0
경기 수원시,좋은마을학교 작은도서관,0,0,35000000,35000000
경기 남양주시,좋은열매 작은도서관,0,0,4800000,4800000
경기 부천시,좋은터작은도서관,0,0,0,0
경기 수원시,주님의교회 문고,100000,0,150000,250000
경기 가평군,주소망도서관,0,0,0,0
경기 시흥시,주안에문고,0,0,0,0
경기 과천시,주암작은도서관,5000000,17564,16372,5033936
경기 여주시,주양작은도서관,100000,0,600000,700000
경기 고양시,주엽작은도서관 행복한 책마을,3000000,0,600000,3600000
경기 부천시,주왕작은도서관,0,0,0,0
경기 양주시,주원작은도서관,0,0,1200000,1200000
경기 안성시,주은풍림도서관,26806000,36061130,8846400,71713530
경기 안양시,주일어린이문고,3000000,0,0,3000000
경기 안성시,죽산도서관,0,29007060,12159850,41166910
경기 성남시,중앙동 작은도서관,10000000,1978700,32557990,44536690
경기 성남시,중원청소년작은도서관,6000000,29000000,4900000,39900000
경기 성남시,즐거운 작은도서관,91200,900000,808800,1800000
경기 남양주시,즐거운도서관,500000,0,0,500000
경기 용인시,즐거운샘터작은도서관,2400000,0,2400000,4800000
경기 여주시,즐거운작은도서관,0,0,0,0
경기 이천시,증포작은도서관,5500000,6600000,8500000,20600000
경기 수원시,지동새마을문고,5000000,0,2400000,7400000
경기 남양주시,지벤꿈터작은도서관,0,0,0,0
경기 김포시,지웰책마루 작은도서관,600000,2640000,50000,3290000
경기 안양시,지혜,0,0,0,0
경기 수원시,지혜문고,500000,0,0,500000
경기 고양시,지혜의 등대,0,0,0,0
경기 고양시,지혜의 샘,0,0,0,0
경기 동두천시,지혜의등대도서관,2500000,21944460,7555540,32000000
경기 안양시,지혜의샘터(선화대새마을문고),1120000,0,0,1120000
경기 성남시,지혜의샘터작은도서관,18450000,34000000,3760000,56210000
경기 포천시,지혜의숲 병영작은도서관,1000000,0,0,1000000
경기 시흥시,진말대우아파트,0,0,0,0
경기 부천시,진말책향기작은도서관,20000000,5471950,8583050,34055000
경기 광주시,진우문고,0,0,0,0
경기 포천시,진호병영작은도서관,0,0,0,0
경기 용인시,징검다리도서관,3000000,0,3000000,6000000
경기 안양시,징검다리어린이,7000000,0,5000000,12000000
경기 화성시,참누리 크로바,0,1200000,3250000,4450000
경기 수원시,참누리레이크도서관,0,1820000,0,1820000
경기 의정부시,참다운어린이도서관,566210,1800000,9991100,12357310
경기 시흥시,참사랑지역아동센터,0,0,0,0
경기 시흥시,참새방앗간작은도서관,1500000,4800000,5000000,11300000
경기 용인시,참솔도서관,1200000,0,120000,1320000
경기 시흥시,참이슬아파트,1000000,0,1800000,2800000
경기 안산시,창조도서관,2800000,9600000,3200000,15600000
경기 파주시,채움도서관,4000000,4590000,500000,9090000
경기 파주시,책 보고 놀자,0,0,0,0
경기 화성시,책과콩나무 작은도서관,200000,400000,100000,700000
경기 시흥시,책나무,0,0,0,0
경기 화성시,책놀이터,2104900,2209100,1200000,5514000
경기 고양시,책놀이터,0,16800000,13000000,29800000
경기 성남시,책누리작은도서관,0,0,2400000,2400000
경기 군포시,책뜨락 혜윰,3500000,2040000,14453000,19993000
경기 의정부시,책마루도서관,1041370,1500000,458630,3000000
경기 부천시,책마을작은도서관,1000000,0,0,1000000
경기 파주시,책만들며크는도서관,10000000,18000000,10000000,38000000
경기 남양주시,책먹는 도서관,6000000,2000000,14400000,22400000
경기 김포시,책사랑글사랑,2000000,0,500000,2500000
경기 용인시,책사랑도서관,2500000,0,500000,3000000
경기 용인시,책사랑쉼터도서관,1000000,0,2000000,3000000
경기 오산시,책을 품은 도서관,2400000,0,13580000,15980000
경기 성남시,책이랑작은도서관,667520,12000000,18699110,31366630
경기 의정부시,책읽는행복도서관,1290000,9010000,3667000,13967000
경기 안산시,책키북키문고,7000000,6000000,3000000,16000000
경기 부천시,천성 작은도서관,0,0,1000000,1000000
경기 수원시,천일새마을문고,5000000,0,2400000,7400000
경기 부천시,천재 작은도서관,0,0,0,0
경기 수원시,천천푸르지오글터,4000000,0,2500000,6500000
경기 광명시,철망산 작은도서관,3200000,0,2050000,5250000
경기 광명시,철산2동 작은도서관,0,0,0,0
경기 의왕시,청계나눔도서관,3030000,1200000,6500000,10730000
경기 의왕시,청계북스토리작은도서관,0,0,0,0
경기 의왕시,청계참고운도서관,11400000,57763000,7014000,76177000
경기 양주시,청담작은도서관,0,0,5350000,5350000
경기 용인시,청명호수마을도서관,1547560,6000000,521840,8069400
경기 연천군,청산작은도서관,2599150,15343350,6800850,24743350
경기 수원시,청소년 쉼터 어린이 도서관,500000,0,0,500000
경기 포천시,청소년교육문화센터 작은도서관,6450000,0,1200000,7650000
경기 양평군,청운작은도서관,0,11520000,0,11520000
경기 용인시,초록도서관,0,0,120000,120000
경기 안산시,초지문고,1000000,3600000,7200000,11800000
경기 안산시,초지작은도서관,15000000,19203516,22009954,56213470
경기 용인시,초코도서관,2000000,120000,600000,2720000
경기 의정부시,초하여행도서관,1555260,11705000,6534960,19795220
경기 부천시,춘의마을작은도서관 상상놀이터,1000000,0,2000000,3000000
경기 성남시,춤추는무지개나무작은도서관,13000000,0,0,13000000
경기 김포시,춤추는책 어린이도서관,0,0,1500000,1500000
경기 수원시,칠보마을작은도서관,500000,0,3100000,3600000
경기 수원시,칠보샘도서관,5000000,0,500000,5500000
경기 용인시,코아루나눔터도서관,2000000,0,0,2000000
경기 안성시,코아루문고,0,340000,0,340000
경기 용인시,콩나물도서관,0,0,150000,150000
경기 군포시,큰꿈어린이도서관,1591280,3200000,8000000,12791280
경기 안양시,큰나무,3600000,19800000,12400000,35800000
경기 김포시,큰나무도서관,0,0,0,0
경기 시흥시,큰맘작은도서관,0,0,850000,850000
경기 수원시,큰바위작은도서관,0,0,0,0
경기 파주시,큰빛어린이문고,800000,0,0,800000
경기 화성시,큰샘도서관,2000000,0,0,2000000
경기 수원시,큰숲작은도서관,600000,0,2000000,2600000
경기 안산시,킹콩도서관,1000000,0,600000,1600000
경기 고양시,탄현 작은도서관,12084000,20661590,8454410,41200000
경기 파주시,탄현작은도서관,6450000,12600000,10400000,29450000
경기 오산시,탈무드 도서관,8500000,0,4300000,12800000
경기 포천시,태봉작은도서관,1200000,0,1800000,3000000
경기 안성시,태산도서관,7000000,20469940,7065773,34535713
경기 수원시,태장동 새마을 문고,5000000,0,2400000,7400000
경기 성남시,태평1동작은도서관,4000000,29103000,2300000,35403000
경기 성남시,태평3동작은도서관,10000000,2500000,13700000,26200000
경기 성남시,태평동작은도서관,1143560,5653899,4601483,11398942
경기 오산시,토라 도서관,200000,1200000,1200000,2600000
경기 군포시,토리작은도서관,2000000,2400000,1500000,5900000
경기 평택시,통미마을작은도서관,600000,0,240000,840000
경기 남양주시,퇴계원사랑도서관,0,18162500,0,18162500
경기 광주시,퇴촌작은도서관,9993910,28657900,5444190,44096000
경기 부천시,파랑새 어린이문고,0,0,0,0
경기 김포시,파랑새작은도서관,0,0,0,0
경기 수원시,파장동 새마을 문고,5000000,0,2400000,7400000
경기 김포시,파크드림작은도서관,1200000,0,1200000,2400000
경기 파주시,파평작은도서관,4000000,13550000,1950000,19500000
경기 성남시,판교LIG 작은도서관,0,0,0,0
경기 안산시,팔곡늘푸른작은도서관,0,0,0,0
경기 안양시,팔복꿈터,0,0,0,0
경기 남양주시,패밀리도서관,0,0,0,0
경기 부천시,팰리스카운티아파트 작은도서관,933000,0,9067000,10000000
경기 남양주시,평강도서관,0,0,0,0
경기 남양주시,평내마을주공아파트 꿈꾸는도서관,500000,0,1200000,1700000
경기 남양주시,평내영어도서관,2000000,10000000,24000000,36000000
경기 수원시,평동새마을문고,5000000,0,2400000,7400000
경기 광명시,평생학습원 청개구리도서관,5911160,36931700,8483150,51326010
경기 시흥시,평안골작은도서관,0,0,0,0
경기 안양시,평안동주민센타,1000000,0,0,1000000
경기 부천시,평화비전작은도서관,0,0,0,0
경기 안산시,평화의 문고,500000,0,500000,1000000
경기 여주시,평화작은도서관,500000,0,500000,1000000
경기 화성시,포도나무 작은도서관,2146735,1300500,7463586,10910821
경기 화성시,포스코반올림 작은도서관,4161540,0,8377841,12539381
경기 평택시,포승작은도서관,66500000,20000000,30000000,116500000
경기 의왕시,포은문고,1300000,0,50000,1350000
경기 의왕시,포일숲속마을1단지도서관,3500000,5000000,0,8500000
경기 부천시,푸르지오2차작은도서관,0,9120000,1500000,10620000
경기 용인시,푸르지오푸른도서관,3510100,24000000,5700000,33210100
경기 화성시,푸른꿈작은도서관,7000000,4317500,6400000,17717500
경기 양주시,푸른꿈작은도서관,0,0,4200000,4200000
경기 용인시,푸른꿈청소년도서관,0,14400000,4800000,19200000
경기 파주시,푸른도서관,1400000,0,400000,1800000
경기 고양시,푸른마을 열린도서실,0,4000000,0,4000000
경기 고양시,푸른마을 작은도서관,14595400,20645420,5959180,41200000
경기 성남시,푸른마을작은도서관,1400000,0,1000000,2400000
경기 성남시,푸른솔작은도서관,1000000,1700000,1400000,4100000
경기 성남시,푸른숲 작은도서관,600000,0,400000,1000000
경기 남양주시,푸른숲문고,200000,0,50000,250000
경기 안양시,푸른어린이,4000000,10800000,5400000,20200000
경기 성남시,푸른어린이작은도서관,683220,12000000,54521867,67205087
경기 양주시,푸른작은도서관,0,0,0,0
경기 화성시,푸른책나라 작은도서관,3000000,0,4000000,7000000
경기 부천시,풍금이 있는 문고,0,0,0,0
경기 의왕시,풍림목련아파트문고,1300000,0,0,1300000
경기 남양주시,풍림숲속의작은도서관,0,0,0,0
경기 김포시,풍무자이글고운작은도서관,0,0,0,0
경기 양주시,풍성한작은도서관,0,0,100000,100000
경기 고양시,프란시스 쉐퍼기념문고,500000,0,600000,1100000
경기 안양시,필승 작은도서관,1120000,0,0,1120000
경기 파주시,하늘꿈도서관,100000,300000,100000,500000
경기 시흥시,하늘꿈작은도서관,1200000,1500000,1000000,3700000
경기 화성시,하늘꿈터도서관,500000,0,0,500000
경기 남양주시,하늘누리작은도서관,5100000,0,1200000,6300000
경기 성남시,하늘달팽이작은도서관,600000,23096000,21112000,44808000
경기 수원시,하늘도서관,0,0,0,0
경기 고양시,하늘도서관,1500000,0,1200000,2700000
경기 수원시,하늘땅 도서관,1200000,0,8400000,9600000
경기 고양시,하늘마을 주공5단지문고,4000000,4800000,1200000,10000000
경기 안성시,하늘마음작은도서관,2400000,0,6000000,8400000
경기 고양시,하늘벗 도서관,1200000,16800000,2000000,20000000
경기 화성시,하늘빛 작은도서관,3600000,720000,3600000,7920000
경기 고양시,하늘빛도서관,0,0,0,0
경기 남양주시,하늘빛문고,0,0,0,0
경기 양주시,하늘빛작은도서관,0,0,1200000,1200000
경기 파주시,하늘선 도서관,4000000,17600000,13000000,34600000
경기 남양주시,하늘소 장난감 도서관,5100000,1300000,2000000,8400000
경기 부천시,하늘이슬작은도서관,0,0,0,0
경기 안산시,하늘작은도서관,0,0,0,0
경기 시흥시,하늘정원,500000,3600000,5000000,9100000
경기 군포시,하늘정원 작은도서관,0,0,5000000,5000000
경기 성남시,하늘창책마루작은도서관,0,0,100000,100000
경기 광명시,하안4동 작은도서관,1600000,0,800000,2400000
경기 파주시,하얀초록 도서관,3500000,1800000,11300000,16600000
경기 성남시,하은어린이작은도서관,0,0,15560000,15560000
경기 연천군,학마을작은도서관,3833350,15343350,5566650,24743350
경기 시흥시,학미숲작은도서관,0,0,8818000,8818000
경기 김포시,한가람 작은도서관,0,13200000,14041704,27241704
경기 시흥시,한가족문고,0,0,3000000,3000000
경기 남양주시,한강 우성아파트도서관,1000000,4500000,2600000,8100000
경기 파주시,한꿈작은도서관,2000000,0,7200000,9200000
경기 성남시,한남작은도서관,3000000,21400000,1000000,25400000
경기 남양주시,한내들작은도서관,100000,0,500000,600000
경기 남양주시,한라반딧불이도서관,5100000,0,1200000,6300000
경기 파주시,한라비발디아파트,5200000,6000000,2050000,13250000
경기 성남시,한림풀에버작은도서관,0,0,0,0
경기 이천시,한마음작은도서관,3500000,6000000,6000000,15500000
경기 용인시,한보라도서관,0,0,360000,360000
경기 성남시,한빛 작은도서관,500000,0,3000000,3500000
경기 부천시,한사랑작은도서관,5000000,4000000,400000,9400000
경기 성남시,한솔 작은도서관,0,37852980,12940000,50792980
경기 오산시,한솔솔파크 문고,0,2400000,300000,2700000
경기 이천시,한솔작은도서관,3000000,4800000,2940000,10740000
경기 성남시,한솔작은도서관,0,0,0,0
경기 안양시,한숲,3000000,0,0,3000000
경기 시흥시,한신아파트,0,0,0,0
경기 안산시,한양새마을작은도서관,3000000,3600000,2400000,9000000
경기 광주시,한우리 문고,3600000,6000000,3000000,12600000
경기 성남시,한우리(태평4동)작은도서관,0,0,0,0
경기 시흥시,한우리독서문화원,0,10000000,4000000,14000000
경기 안양시,한울,1700000,0,1320000,3020000
경기 이천시,한울림도서관,7000000,6500000,2100000,15600000
경기 파주시,한울작은도서관,4077690,6360960,575250,11013900
경기 수원시,한울타리작은도서관,360,0,240,600
경기 화성시,한일타운마을문고,3898800,1200000,3352000,8450800
경기 의왕시,한진로즈힐아파트문고,1500000,0,0,1500000
경기 파주시,한톨작은도서관,5543350,0,9456650,15000000
경기 화성시,한화꿈에그린아파트도서관,2400000,4800000,300000,7500000
경기 남양주시,한화꿈에그린아파트문고,10000000,0,0,10000000
경기 화성시,한화우림작은도서관,7500000,0,6100000,13600000
경기 안산시,함박드림 새마을 작은도서관,12000000,8000000,20160000,40160000
경기 시흥시,함현공원작은도서관,0,0,5000000,5000000
경기 수원시,해늘작은도서관,7216590,0,3055240,10271830
경기 수원시,해님달님작은도서관,2200000,3600000,15800000,21600000
경기 양주시,해달별작은도서관,200000,0,3000000,3200000
경기 성남시,해담은푸그작은도서관,3000000,0,1200000,4200000
경기 용인시,해든도서관,1276000,6000000,3718850,10994850
경기 화성시,해뜰문고,4000000,9600000,3000000,16600000
경기 용인시,해맑은문고,0,0,600000,600000
경기 안산시,해맑음작은도서관,0,0,0,0
경기 광명시,해모로 이연 작은도서관,2000000,2000000,200000,4200000
경기 용인시,해밀도서관,1500000,683700,18000000,20183700
경기 남양주시,해밀마을작은도서관,0,0,0,0
경기 남양주시,해밀인스빌 꿈꾸는도서관,0,0,3000000,3000000
경기 안양시,해성,0,3200000,636000,3836000
경기 하남시,해오름 작은도서관 ,4565000,6893740,21759680,33218420
경기 용인시,해오름도서관,1000000,6000000,4500000,11500000
경기 군포시,해오름문고,0,0,0,0
경기 부천시,해오름작은도서관,100000,0,450000,550000
경기 성남시,해피드림 작은도서관,0,0,0,0
경기 고양시,해피북문고,700000,0,300000,1000000
경기 화성시,해피트리 작은도서관,0,0,0,0
경기 고양시,햇빛21작은도서관,15881000,20685340,4833660,41400000
경기 고양시,햇빛마을 작은도서관,7710230,20895460,12492920,41098610
경기 화성시,햇살마루작은도서관,2585110,5000000,985270,8570380
경기 부천시,햇살이가득한도서관,10000000,21813900,23892000,55705900
경기 수원시,행궁동 새마을문고,5000000,0,2400000,7400000
경기 안성시,행복나눔 작은도서관,0,0,0,0
경기 화성시,행복담은,2400000,0,1200000,3600000
경기 파주시,행복동네도서관,600000,600000,1200000,2400000
경기 부천시,행복듬book 작은도서관,5300000,3000000,0,8300000
경기 화성시,행복한,3499000,2400000,3800000,9699000
경기 고양시,행복한 도서관,0,0,0,0
경기 부천시,행복한 도서관,10000000,21813900,23228280,55042180
경기 파주시,행복한도서관,1000000,0,1000000,2000000
경기 남양주시,행복한마을도서관,0,0,0,0
경기 안산시,행복한마을작은도서관,0,0,0,0
경기 성남시,행복한작은도서관,1000000,5000000,1000000,7000000
경기 양주시,행복한작은도서관,0,0,1200000,1200000
경기 부천시,향기나는작은도서관,0,0,0,0
경기 용인시,향상어린이문고,0,2400000,1200000,3600000
경기 안양시,향촌,1700000,0,1320000,3020000
경기 이천시,헤븐영어작은도서관,0,480000,1500000,1980000
경기 용인시,현대 호롱마루 도서관,2000000,0,3600000,5600000
경기 화성시,현대아이파크 어린이 작은 도서관,5000000,0,7000000,12000000
경기 광명시,현대아파트 작은도서관,3200000,0,6550000,9750000
경기 광명시,현진꿈꾸는 작은도서관,3200000,0,4350000,7550000
경기 양주시,현진숲속작은도서관,1500000,0,2400000,3900000
경기 파주시,혜윰도서관,0,0,2425024,2425024
경기 안양시,호계1동주민센타,19000000,0,0,19000000
경기 안양시,호계3동 주민센터,0,0,0,0
경기 성남시,호도애작은도서관,3000000,16000000,6000000,25000000
경기 용인시,호반두드림도서관,6003895,0,5930018,11933913
경기 용인시,호반작은도서관,1200000,2600000,1200000,5000000
경기 수원시,호반작은도서관,0,0,250000,250000
경기 고양시,호수공원작은도서관,8400000,20633000,5730000,34763000
경기 용인시,호수마을 월드문고,700000,0,1700000,2400000
경기 의정부시,호원1동작은도서관,7200000,13800000,1992857,22992857
경기 남양주시,호평작은도서관,7200000,60000000,2000000,69200000
경기 안양시,홈타운,1700000,0,1320000,3020000
경기 남양주시,화도다문화도서관,5100000,0,0,5100000
경기 남양주시,화도아띠랑작은도서관,5100000,0,0,5100000
경기 수원시,화서1동 새마을 문고,5000000,0,2400000,7400000
경기 수원시,화서2동 새마을문고,5000000,0,2400000,7400000
경기 수원시,화서영광새마을문고,5000000,0,2400000,7400000
경기 화성시,화성동부청소년도서관,1000000,0,800000,1800000
경기 고양시,화전작은도서관,13252130,20645490,7302380,41200000
경기 수원시,황골작은도서관,0,0,2000000,2000000
경기 가평군,횃불병영도서관,0,0,0,0
경기 평택시,효성백년가약작은도서관,2000000,6000000,9150000,17150000
경기 이천시,효양작은도서관,3000000,4800000,1440000,9240000
경기 용인시,효천작은도서관,0,0,0,0
경기 양주시,효촌작은도서관,0,0,1200000,1200000
경기 파주시,휴먼빌샘터 작은도서관,6000000,17520000,8000000,31520000
경기 화성시,휴먼빌아파트 작은도서관,96000,1030000,475800,1601800
경기 의정부시,휴먼시아도서관,255330,1800000,2175780,4231110
경기 용인시,흥덕마을3단지 작은도서관,0,0,0,0
경기 안양시,희망,32000000,1600000,4400000,38000000
경기 의정부시,희망Library Center,19500000,27600000,20500000,67600000
경기 파주시,희망도서관,1600000,0,500000,2100000
경기 성남시,희망등대작은도서관,1159110,21600000,76935505,99694615
경기 안양시,희망세움,5000000,0,300000,5300000
경기 부천시,희망을 여는 작은도서관,1200000,800000,2400000,4400000
경기 성남시,희망작은도서관,0,0,0,0
경기 이천시,희망작은도서관,3500000,4800000,3600000,11900000
경기 광명시,희망작은도서관,3200000,4800000,2050000,10050000
경기 양주시,희망작은도서관,0,1800000,2160000,3960000
경기 시흥시,힐스테이트아파트 힐스그루터기,3600000,7200000,1200000,12000000
경기 파주시,힐스테이트작은도서관,900000,8400000,2100000,11400000
경기 용인시,힐작은도서관,1700000,0,300000,2000000
경남 사천시,(사)한국문화교육진흥회 사천지부작은도서관,2900000,20200000,9200000,32300000
경남 김해시,U.보라작은도서관,3240000,16394040,1965960,21600000
경남 밀양시,가곡동작은도서관,2500000,0,500000,3000000
경남 양산시,가람휘작은도서관,500000,0,1000000,1500000
경남 합천군,가야아동센터작은도서관,1200000,0,0,1200000
경남 합천군,가야작은도서관,2400000,27431000,4222800,34053800
경남 창원시,가음정평생교육센터,6000000,30000000,9600000,45600000
경남 거창군,가조면작은도서관,0,14500000,4000000,18500000
경남 진주시,가좌3주공 작은도서관,3001800,1800000,1528230,6330030
경남 진주시,가호동 새마을문고,2000000,0,500000,2500000
경남 의령군,갑을동산문고,1400000,0,600000,2000000
경남 진주시,강남동 새마을문고,0,0,0,0
경남 양산시,강변마을작은도서관,0,300000,0,300000
경남 거제시,거제면참새미작은도서관,31016720,3679870,52233280,86929870
경남 양산시,경남아너스빌작은도서관,5000000,0,6000000,11000000
경남 진주시,경남혁신 꿈꾸는 도서관,0,0,0,0
경남 창녕군,고곡새마을문고,0,0,0,0
경남 양산시,고맙습니다물구나무도서관,8000000,0,8600000,16600000
경남 사천시,곤명 꿈나무 작은도서관,3400000,3000000,0,6400000
경남 하동군,공감마루 작은도서관,10000000,5000000,3000000,18000000
경남 합천군,관기문고,1400000,0,480000,1880000
경남 통영시,광도면새마을작은도서관,0,0,5613100,5613100
경남 함양군,구세군사랑듬book작은도서관,0,0,0,0
경남 창원시,구암1동 새마을문고,3600000,7800000,3000000,14400000
경남 창원시,구암2동 새마을문고,3600000,7800000,3000000,14400000
경남 양산시,글고은작은도서관,5000000,0,6000000,11000000
경남 함안군,글누리도서관,1160670,4800000,2304000,8264670
경남 김해시,글로벌영어도서관(서김해지부),500000,23000000,15000000,38500000
경남 양산시,글마루작은도서관,5500000,3600000,3600000,12700000
경남 거제시,글밭 작은도서관 ,5000000,0,0,5000000
경남 창원시,글벗나래 작은도서관,10000000,20000000,280000,30280000
경남 진주시,글샘누리 작은도서관,2000000,0,0,2000000
경남 김해시,글혜윰작은도서관,4480000,16280000,3340000,24100000
경남 진주시,금빛마을작은도서관,5236000,9360000,1746490,16342490
경남 진주시,금산 아이파크 새마을 작은도서관,3000000,0,1100000,4100000
경남 김해시,김해글로벗도서관,6671350,22381160,6947580,36000090
경남 창원시,까르딘도서관,900000,15600000,4450000,20950000
경남 합천군,꿈꾸는 도서관,1200000,0,200000,1400000
경남 김해시,꿈꾸는숲속작은도서관,500000,0,0,500000
경남 진주시,꿈아루도서관,0,0,4000000,4000000
경남 창원시,꿈이있는 노블도서관,6000000,14400000,2600000,23000000
경남 진주시,꿈이있는도서관,0,0,0,0
경남 사천시,꿈크루작은도서관,0,0,30000000,30000000
경남 의령군,꿈터문고,1000000,0,0,1000000
경남 양산시,꿈터작은도서관,5000000,3600000,6000000,14600000
경남 함안군,남경새마을문고,100,0,200,300
경남 남해군,남면새마을문고,2000000,0,0,2000000
경남 거제시,남부면 작은도서관,6000000,8055550,0,14055550
경남 창원시,남산평생교육센터,6000000,30000000,9600000,45600000
경남 창원시,남양평생교육센터,6000000,30000000,9600000,45600000
경남 창녕군,남지중앙 작은도서관,120000,0,0,120000
경남 창원시,내동평생교육센터,6000000,30000000,9600000,45600000
경남 창원시,내서읍새마을문고,4000000,7800000,3000000,14800000
경남 김해시,내외작은도서관,1252490,16279000,2868510,20400000
경남 함양군,녹색대학문고,600000,0,300000,900000
경남 김해시,늘사랑주민도서관,0,0,0,0
경남 창원시,늘푸른 도서관,6000000,15000000,6600000,27600000
경남 하동군,늘푸른 작은도서관,1000000,5000000,3000000,9000000
경남 밀양시,늘푸른도서관,3000000,5000000,0,8000000
경남 창원시,늘푸른문고,0,0,1200000,1200000
경남 양산시,다숲작은도서관,500,0,0,500
경남 산청군,단계슬기문고,500000,0,0,500000
경남 진주시,대곡면 새마을문고,0,0,0,0
경남 산청군,대동강변타운 새마을 작은 도서관,0,0,1200000,1200000
경남 창원시,대동다숲작은도서관,3707450,8400626,2892993,15001069
경남 양산시,대동아파트작은도서관,5000000,4800000,6000000,15800000
경남 양산시,대동이미지작은도서관,4000000,6000000,4800000,14800000
경남 김해시,대동푸른뜰작은도서관,874860,14560000,4965140,20400000
경남 김해시,대동한마음 작은도서관,1100000,16000000,3300000,20400000
경남 사천시,대방 작은도서관,3400000,3000000,0,6400000
경남 창원시,대방그린빌마을도서관,3000000,20000000,6500000,29500000
경남 창원시,대방평생교육센터,12200000,38400000,12000000,62600000
경남 함안군,대산면 새마을 작은도서관,1000000,0,2000000,3000000
경남 창원시,대산평생교육센터,6340000,31630000,10556066,48526066
경남 양산시,대석햇살작은도서관,5000000,0,6000000,11000000
경남 거제시,대아푸른솔아파트작은도서관,0,0,1200000,1200000
경남 창원시,대원평생교육센터,7505000,66659390,22299333,96463723
경남 김해시,대청로문고,0,0,0,0
경남 김해시,대포천작은도서관,1041600,13311530,7100000,21453130
경남 창녕군,대합새마을문고,0,0,0,0
경남 창원시,더시티세븐자이도서관,1200000,13994640,0,15194640
경남 거제시,덕산아내프리미엄아파트 작은도서관,0,10800000,3564000,14364000
경남 김해시,덕산작은도서관,3251550,14515930,5032520,22800000
경남 통영시,도산면새마을작은도서관,2478500,11760000,1796000,16034500
경남 통영시,도천동새마을작은도서관,2472900,0,1761000,4233900
경남 합천군,도토리와 친구들,1200000,0,0,1200000
경남 사천시,동강아뜨리에작은도서관,4400000,3000000,0,7400000
경남 양산시,동면극동작은도서관,5000000,0,6000000,11000000
경남 진주시,동산도서관,0,0,0,0
경남 양산시,동원로얄듀크작은도서관,5000000,0,6000000,11000000
경남 창원시,동읍평생교육센터,6000000,30000000,9600000,45600000
경남 진주시,동진주 어린이 작은 도서관,3000000,300000,200000,3500000
경남 김해시,두란노작은도서관,6000000,0,30000000,36000000
경남 진주시,두산위브글마루도서관,4008230,4778580,411990,9198800
경남 밀양시,들꽃 도서관,0,0,0,0
경남 진주시,디딤돌,1000000,0,9672502,10672502
경남 양산시,디딤돌작은도서관,6000000,6000000,7200000,19200000
경남 창원시,디지털마을도서관,6000000,13800000,6600000,26400000
경남 김해시,떡갈나무숲작은도서관,1450260,14550000,4399740,20400000
경남 김해시,뜨란채작은도서관,1379370,15906210,3114420,20400000
경남 사천시,리가 작은도서관,7400000,3000000,3000000,13400000
경남 김해시,리첼작은도서관,534420,14129520,6133380,20797320
경남 진주시,마하어린이도서관,5000000,19200000,15000000,39200000
경남 의령군,만산솥바위문고,1163000,0,120000,1283000
경남 함양군,맑은샘열린문고,0,0,0,0
경남 진주시,망경한보아파트 새마을문고,0,0,0,0
경남 함안군,메트로자이 작은도서관,3577470,13680000,322850,17580320
경남 창원시,명곡평생교육센터,6460000,62000000,11200000,79660000
경남 창원시,명서1평생교육센터,6300000,30000000,10800000,47100000
경남 창원시,명서2평생교육센터,6000000,30000000,9600000,45600000
경남 거제시,모오리돌작은도서관,10000000,0,0,10000000
경남 합천군,묘산중앙문고,3200000,0,1000000,4200000
경남 남해군,무림도서관,200000,0,0,200000
경남 밀양시,무안면 새마을문고,0,0,0,0
경남 창원시,무학산블루밍작은도서관,6000000,15000000,6600000,27600000
경남 창원시,문화동책사랑방작은도서관,1800000,0,3600000,5400000
경남 진주시,미누마루도서관,1200000,12000000,840000,14040000
경남 양산시,미라주글사랑작은도서관,3000000,3600000,3500000,10100000
경남 김해시,미래티움도서관,4000000,12000000,3600000,19600000
경남 통영시,미수동새마을작은도서관,3699500,11760000,1768000,17227500
경남 통영시,미수휴먼시아새마을작은도서관,2027500,0,3010000,5037500
경남 남해군,미조등대지기도서관,200000,0,0,200000
경남 남해군,민들레어린이도서관,2000000,0,0,2000000
경남 함양군,밀알공부방문고,600000,0,0,600000
경남 거제시,바람의 언덕작은도서관,200000,0,400000,600000
경남 양산시,반도유보라문고,4000000,0,2400000,6400000
경남 창원시,반딧불이도서관,6000000,15000000,6600000,27600000
경남 창원시,반림마을도서관,6000000,15000000,6600000,27600000
경남 창원시,반월작은도서관,6000000,15000000,6600000,27600000
경남 창원시,반지평생교육센터,8500000,62700000,18260000,89460000
경남 양산시,백년가약작은도서관,5000000,0,6000000,11000000
경남 사천시,벌리주공 푸른 작은도서관,3400000,3000000,0,6400000
경남 합천군,보름달 문고,2150000,0,0,2150000
경남 의령군,보천과채마을문고,1000000,0,0,1000000
경남 창원시,봉곡평생교육센터,6116380,55574090,20821500,82511970
경남 창원시,봉림평생교육센터,7007040,33222681,50036497,90266218
경남 진주시,봉안동새마을문고,0,0,0,0
경남 창원시,봉암동작은도서관,1500000,3450000,1650000,6600000
경남 양산시,봉우별떨기작은도서관,5000000,0,6000000,11000000
경남 통영시,봉평동새마을작은도서관,2309400,0,1215000,3524400
경남 창녕군,부곡새마을문고,0,0,0,0
경남 창원시,부림희망작은도서관,6000000,15000000,6600000,27600000
경남 통영시,북신동새마을작은도서관,3683700,0,1761000,5444700
경남 하동군,북천 남포 새마을문고,0,0,500000,500000
경남 김해시,분성아이파크 작은도서관,6550000,15530000,3320000,25400000
경남 김해시,불암동작은도서관,787900,18641800,3730030,23159730
경남 진주시,빛나는 혁신LH1단지도서관,0,0,0,0
경남 의령군,사랑방문고,1200000,0,800000,2000000
경남 창원시,사림평생교육센터,6450000,52400000,15200000,74050000
경남 진주시,사봉글사랑,0,0,0,0
경남 사천시,사천함께하는 다문화도서관,500000,0,500000,1000000
경남 창원시,사파동성마을도서관,6000000,25239100,8938320,40177420
경남 창원시,사파평생교육센터),6000000,60609000,7972000,74581000
경남 밀양시,산외면 문고,0,0,0,0
경남 산청군,산청읍 새마을문고,0,0,0,0
경남 합천군,삼가장터3.1광장도서관,1500000,0,800000,2300000
경남 김해시,삼계로얄작은도서관,4320090,13457120,5647480,23424690
경남 김해시,삼계푸르지오작은도서관,1700000,16300000,2400000,20400000
경남 양산시,삼성한마음작은도서관,5000000,6000000,6000000,17000000
경남 창원시,삼익아파트마을도서관,120000,0,0,120000
경남 사천시,삼한노인대학 작은도서관,3400000,3000000,0,6400000
경남 창원시,상곡 어울림 작은 도서관,6000000,13800000,6600000,26400000
경남 창원시,상남평생교육센터,6000000,30000000,9600000,45600000
경남 진주시,상대1동 새마을문고 현대분소,0,0,0,0
경남 진주시,상대1동 열린 작은도서관,0,0,0,0
경남 진주시,상대2동새마을문고,3000000,0,0,3000000
경남 진주시,상대한보 아파트 작은도서관,0,0,0,0
경남 합천군,상록농촌문화도서관,200000,0,150000,350000
경남 진주시,상봉동 봉원 새마을 문고,3000000,0,0,3000000
경남 진주시,상봉동동2 새마을문고,0,0,0,0
경남 진주시,상봉동새마을작은도서관,0,0,0,0
경남 진주시,상봉봉동자율방범대 새마을문고,0,0,0,0
경남 진주시,상평동 새마을작은도서관,0,0,0,0
경남 진주시,상평동일스위트혜윰문고,3000000,0,0,3000000
경남 함안군,새마을문고 동신아파트 작은도서관,1100000,0,2300000,3400000
경남 거제시,새마을문고 작은도서관,3200000,0,0,3200000
경남 창녕군,새마을문고 작은도서관,0,0,0,0
경남 의령군,새마을문고센터,1000000,0,0,1000000
경남 남해군,새마을문고현대아파트도서관,2000000,0,0,2000000
경남 거창군,새마을시범문고,0,0,0,0
경남 창원시,새순어린이도서관,4000000,0,4000000,8000000
경남 통영시,새싹작은도서관,0,0,0,0
경남 통영시,새통영작은도서관,0,0,0,0
경남 합천군,샛별도서관,3000000,0,0,3000000
경남 사천시,생각을 키우는 작은 도서관,3400000,3000000,0,6400000
경남 김해시,생각이크는작은도서관,1513200,14040950,4845850,20400000
경남 산청군,생초면 새마을문고,0,0,0,0
경남 함양군,서하면새마을문고,0,0,0,0
경남 김해시,석봉마을작은도서관,4000000,16500000,2000000,22500000
경남 창원시,석전2동 새마을문고,3600000,7800000,3000000,14400000
경남 산청군,선비마을 작은도서관 ,898221,0,0,898221
경남 함안군,성내 그루터기 작은도서관,2000000,1000000,2000000,5000000
경남 창녕군,성산면 새마을문고,0,0,0,0
경남 거제시,성은 작은도서관,0,0,1500000,1500000
경남 창원시,성주마을도서관,7368300,30000000,8231700,45600000
경남 창원시,소계평생교육센터,6592570,63287405,10903357,80783332
경남 김해시,소리작은도서관,5136320,31800000,19463320,56399640
경남 양산시,소주동작은도서관,1000000,0,0,1000000
경남 사천시,송보작은도서관,3400000,3000000,480000,6880000
경남 함양군,수동면새마을문고,0,0,0,0
경남 함안군,수림 작은도서관,1100000,0,3600000,4700000
경남 창원시,숲속마을도서관,13800000,4800000,5400000,24000000
경남 남해군,숲속작은도서관,2000000,0,0,2000000
경남 사천시,시민문화센터 작은도서관,0,30955000,458000,31413000
경남 김해시,시호미래작은도서관,668760,14129520,5601720,20400000
경남 양산시,신기주공작은도서관,5000000,0,6000000,11000000
경남 함안군,신나는 도서관,1300000,0,3000000,4300000
경남 진주시,신안1차 주공아파트 새마을문고,0,0,0,0
경남 창원시,신월평생교육센터,6000000,30000000,9600000,45600000
경남 양산시,신창비바패밀리작은도서관,6000000,0,7200000,13200000
경남 함양군,심산문고,0,0,0,0
경남 창원시,십대의문고,0,0,0,0
경남 양산시,쌍용하늘작은도서관,5000000,4800000,6000000,15800000
경남 함양군,썬샤인작은도서관,500000,6000000,1380000,7880000
경남 진주시,아름다운 작은도서관,1000000,0,0,1000000
경남 김해시,아이러브영어도서관,4500000,1200000,4800000,10500000
경남 하동군,악양 작은도서관 책보따리,1000000,5000000,5500000,11500000
경남 창원시,안민고을도서관,1000000,500000,960000,2460000
경남 창원시,안민마을도서관,6000000,15000000,6600000,27600000
경남 창원시,안민청솔마을도서관,6000000,15000000,6600000,27600000
경남 통영시,안정작은도서관,11360800,0,10355000,21715800
경남 합천군,야로교회문고,2200000,0,1000000,3200000
경남 창원시,양덕1동 새마을문고,3600000,7800000,3000000,14400000
경남 창원시,양덕2동 새마을문고,4600000,7800000,3000000,15400000
경남 양산시,양산종합사회복지관행복한도서실,5000000,0,0,5000000
경남 양산시,양산타워작은도서관,5000000,0,0,5000000
경남 양산시,에버빌작은도서관,5000000,0,6000000,11000000
경남 함양군,여울목의탄문고,0,0,0,0
경남 진주시,연세 작은도서관,0,0,0,0
경남 창녕군,영산새마을문고,0,0,0,0
경남 하동군,옥종 새마을문고,0,0,500000,500000
경남 거제시,옥포작은도서관,12000000,18000000,8738000,38738000
경남 진주시,온새미로도서관,0,0,0,0
경남 창원시,옹달샘문고,3200000,1200000,3600000,8000000
경남 양산시,옹달샘작은도서관,5000000,3000000,6000000,14000000
경남 사천시,용강주공 느티나무 작은도서관,3400000,3000000,0,6400000
경남 통영시,용남면새마을작은도서관,6094000,0,2628000,8722000
경남 창원시,용잠마을도서관,6000000,15000000,6600000,27600000
경남 창원시,용지평생교육센터,6400280,57142580,10489610,74032470
경남 양산시,우남작은도서관,5000000,0,6000000,11000000
경남 창원시,우리동네도서관,600000,0,0,600000
경남 양산시,우리동네작은도서관,0,0,4900000,4900000
경남 진주시,우리마을도서관,0,0,1800000,1800000
경남 김해시,우리작은도서관,827600,13485360,6914640,21227600
경남 통영시,우리행복한도서관,0,0,0,0
경남 양산시,우미마을작은도서관,348900,0,1900000,2248900
경남 창원시,우성아파트새마을문고,3600000,8400000,3000000,15000000
경남 창원시,웅남평생교육센터,6000000,30000000,9600000,45600000
경남 양산시,웅상종합사회복지관 꿈마루작은도서관,0,0,0,0
경남 양산시,웅상푸르지오작은도서관,5000000,0,6000000,11000000
경남 김해시,월산주공작은도서관,1643040,13405680,5351280,20400000
경남 김해시,율상마을푸르지오작은도서관,4000000,9000000,600000,13600000
경남 김해시,율하e편한작은도서관,2100514,16297779,2001707,20400000
경남 남해군,은모래작은도서관,2000000,0,0,2000000
경남 의령군,의령덕암교회문고,1600000,0,1200000,2800000
경남 창원시,의창평생교육센터,8213360,68071247,18360959,94645566
경남 창원시,이미지작은도서관,4800000,13800000,7800000,26400000
경남 김해시,이안나누리작은도서관,6000000,18743580,2856420,27600000
경남 사천시,이안애작은도서관,3400000,0,600000,4000000
경남 양산시,이편한 작은 도서관,5000000,3600000,6000000,14600000
경남 진주시,이현동 웰가아파트 새마을문고,1000000,0,500000,1500000
경남 김해시,일동미라주아파트작은도서관,0,0,0,0
경남 김해시,일동한신꿈나무작은도서관,793230,16956000,2650770,20400000
경남 창원시,일신숲속마을작은도서관,2000000,0,100000,2100000
경남 창원시,자산마을문고,1500000,2400000,1200000,5100000
경남 창원시,자여마을도서관,6000000,15000000,6600000,27600000
경남 진주시,자이새마을작은도서관,1845210,0,0,1845210
경남 진주시,작은 영어도서관,0,0,0,0
경남 창원시,작은숲영어도서관,829510,1160000,9442110,11431620
경남 창녕군,장마새마을문고,0,0,0,0
경남 김해시,장유대우작은도서관,344740,13371450,6683810,20400000
경남 하동군,적량(죽치)새마을문고,0,0,500000,500000
경남 합천군,적중문고,1200000,0,0,1200000
경남 통영시,정량동새마을작은도서관,6523200,0,1680000,8203200
경남 진주시,정촌면 새마을문고(정촌글샘),4000000,0,1500000,5500000
경남 진주시,제자교회부설 예닮작은도사관,2000000,500000,3000000,5500000
경남 김해시,젤미작은도서관,3200000,16260000,3740000,23200000
경남 진주시,주약현대마을도서관 다락,3017940,0,3578224,6596164
경남 김해시,주촌디딤돌작은도서관,2100000,13710270,4589730,20400000
경남 통영시,중앙동새마을작은도서관,2465900,0,1873000,4338900
경남 진주시,중앙성결문고,0,0,0,0
경남 진주시,중앙어린이도서관,0,0,0,0
경남 창원시,중앙평생교육센터,6000000,30000000,9600000,45600000
경남 하동군,중일 새마을문고,0,0,500000,500000
경남 김해시,중흥샘이깊은작은도서관,1739370,15306960,3483520,20529850
경남 함양군,지리산(군부대) 새마을문고,0,0,0,0
경남 하동군,지리산반달작은도서관 ,1000000,5000000,5500000,11500000
경남 함양군,지리산한울문고,0,0,0,0
경남 창녕군,지산각(창녕고등학교 도서관),5000000,22908600,1000000,28908600
경남 통영시,지식충전소,9292000,0,0,9292000
경남 창녕군,지혜누리(계창우리학교마을도서관),4333000,4986000,1590000,10909000
경남 김해시,진례작은도서관,730000,15306960,4363040,20400000
경남 사천시,진사주공작은도서관,0,3000000,0,3000000
경남 김해시,진영소망작은도서관,1000000,0,0,1000000
경남 진주시,진주YWCA다문화작은도사관 단비,3000000,0,0,3000000
경남 진주시,진주여성회부설 달팽이어린이 도서관,8400000,16800000,10000000,35200000
경남 창원시,진해 자은3주공아파트문고,0,0,0,0
경남 창원시,진해그루터기문고,5481319,0,560000,6041319
경남 진주시,집현면 새마을문고,1000000,0,0,1000000
경남 진주시,착한마음도서관,2000000,1000000,1000000,4000000
경남 진주시,참좋은작은도서관,4000000,0,600000,4600000
경남 창원시,창원다문화어린이도서관,3000000,30000000,15000000,48000000
경남 창원시,창원시아이세상장난감도서관,20000000,156070513,88930000,265000513
경남 김해시,책고래작은도서관,5163000,14541000,6696000,26400000
경남 사천시,책놀이터어린이작은도서관,4300000,6000000,3000000,13300000
경남 의령군,책동이마을문고,1100000,0,0,1100000
경남 사천시,책마루도서관,3400000,3000000,680000,7080000
경남 고성군,책사랑작은도서관,4000000,14400000,21000000,39400000
경남 창원시,책사랑회내서마을도서관,5651070,34855500,5733145,46239715
경남 진주시,책읽는푸른마을도서관,4311000,0,6855000,11166000
경남 창원시,천주평생교육센터,6000000,30000000,9600000,45600000
경남 양산시,청어람아파트새마을문고,6000000,7200000,7200000,20400000
경남 하동군,청학 작은도서관,1000000,5000000,4500000,10500000
경남 하동군,청학골새마을도서관,0,0,500000,500000
경남 밀양시,초동작은도서관,5000000,0,200000,5200000
경남 진주시,초록에뜰 작은도서관,3600000,0,0,3600000
경남 진주시,초전 해모로 루비채 2단지 북카페,0,0,0,0
경남 진주시,초전푸르지오1단지작은도서관,7600000,5400000,1200000,14200000
경남 함안군,칠원대동 새마을문고,1000000,600000,600000,2200000
경남 김해시,캐슬작은도서관,1610410,15857920,6531670,24000000
경남 양산시,코아루작은도서관,7400000,0,8400000,15800000
경남 사천시,큰꿈 작은도서관,2000000,2400000,1000000,5400000
경남 합천군,토끼와거북이리더십도서관,2150000,0,0,2150000
경남 통영시,통영시민교회 작은도서관,1000000,0,0,1000000
경남 창원시,트리비앙도서관,7760000,19000000,2900000,29660000
경남 창원시,팔룡평생교육센터,6783860,56950340,21376109,85110309
경남 김해시,팔판작은도서관,3217280,13846890,14995430,32059600
경남 진주시,평거동 새마을 작은도서관,3000000,0,0,3000000
경남 진주시,평거휴먼시아3단지글샘누리,2000000,0,0,2000000
경남 사천시,평생학습센터 작은도서관,0,19600000,14572000,34172000
경남 진주시,푸르미작은도서관,3000000,0,0,3000000
경남 통영시,푸르지오1차새마을작은도서관,2496100,0,1782000,4278100
경남 거제시,푸른숲 작은도서관,9000000,26400000,15618536,51018536
경남 김해시,푸른숲작은도서관,3000000,0,1200000,4200000
경남 진주시,핑크드림도서관,5760000,0,6348950,12108950
경남 함안군,하늘꿈 작은 도서관,0,0,0,0
경남 김해시,하늘빛작은도서관,2400000,13994640,5205000,21599640
경남 진주시,하늘소작은도서관,0,0,0,0
경남 창원시,하늘채문화의집작은도서관,4800000,12600000,5400000,22800000
경남 진주시,하대1동 새마을문고,2000000,0,0,2000000
경남 함양군,학동새마을문고,0,0,0,0
경남 김해시,한국작은도서관,1800000,16271280,3060000,21131280
경남 김해시,한길솔로몬작은도서관,1000000,0,3600000,4600000
경남 양산시,한내들작은도서관,5000000,0,6000000,11000000
경남 창원시,한림리츠빌새마을문고,4224660,8400000,2379395,15004055
경남 창원시,한빛어린이도서관,4500000,0,11500000,16000000
경남 김해시,한신책사랑작은도서관,864830,16279000,3256170,20400000
경남 진주시,한우리 독서문화원,0,0,0,0
경남 양산시,한일양지뜸작은도서관,5000000,5000000,6000000,16000000
경남 사천시,한주빌라트 늘푸른작은도서관,3400000,3000000,0,6400000
경남 함안군,함안군새마을작은도서관,1000000,0,0,1000000
경남 함안군,함안주공새마을작은도서관,1000000,0,100000,1100000
경남 함양군,함양경찰서 새마을문고,0,0,0,0
경남 창원시,합성 가고파 작은도서관,6000000,13800000,6600000,26400000
경남 창원시,합성2동 새마을문고,3600000,7800000,3000000,14400000
경남 합천군,합천군새마을문고센터,1200000,8074640,6633000,15907640
경남 의령군,햇살문고,2000000,0,0,2000000
경남 산청군,행복미소작은도서관,1000000,0,5040000,6040000
경남 진주시,행복소리 작은도서관,0,0,0,0
경남 합천군,행복한 아이터,1200000,0,300000,1500000
경남 김해시,행복한작은도서관,500000,6000000,3500000,10000000
경남 합천군,향파새마을문고,6490000,0,956273,7446273
경남 사천시,현대 작은도서관,3400000,3000000,0,6400000
경남 창원시,호계영어도서관,1500000,0,500000,2000000
경남 하동군,화개 삼신 새마을문고,0,0,500000,500000
경남 양산시,화성파크드림작은도서관,0,0,0,0
경남 김해시,활천행복작은도서관,6926860,14400000,9073140,30400000
경남 산청군,황금수레,0,0,0,0
경남 양산시,황전새마을문고,5000000,6000000,6000000,17000000
경남 창원시,회성동새마을문고,7800000,3600000,3000000,14400000
경남 창원시,회원1동새마을문고 ,3600000,7800000,1000000,12400000
경남 사천시,훼미리작은도서관,3540000,3000000,0,6540000
경남 진주시,휴먼빌 꿈꾸는 도서관,0,0,0,0
경남 양산시,휴먼빌둥지작은도서관,4000000,0,4800000,8800000
경남 함양군,휴먼시아새마을문고,3500000,0,0,3500000
경남 하동군,희망 작은도서관,1000000,5000000,3000000,9000000
경남 창녕군,희망나무도서관,0,18000000,0,18000000
경남 합천군,희망문고,2150000,0,0,2150000
경남 남해군,희망키움 새마을문고,2000000,0,0,2000000
경북 칠곡군,2주공 새마을작은도서관,600000,5800000,600000,7000000
경북 칠곡군,3주공작은도서관,1152000,6000000,2000000,9152000
경북 칠곡군,4주공새마을작은도서관,0,0,0,0
경북 구미시,e.편한 새마을문고,3600000,0,3000000,6600000
경북 구미시,가시골 새마을문고,1000000,0,2200000,3200000
경북 영주시,가흥2동작은도서관,500000,0,0,500000
경북 구미시,강변새마을문고,0,0,0,0
경북 청송군,객주 소설도서관,20000000,1400000,2000000,23400000
경북 경산시,경동북문고,0,0,0,0
경북 경산시,계양작은도서관,4000000,0,300000,4300000
경북 김천시,고래실 작은도서관,8100000,9000000,4800000,21900000
경북 고령군,고령새마을문고,0,0,0,0
경북 경주시,고맙습니다해송작은도서관,1104380,0,1196000,2300380
경북 칠곡군,공원새마을작은도서관,2600000,2400000,2000000,7000000
경북 포항시,구룡포 작은도서관,0,0,0,0
경북 포항시,구룡포읍 미르아라작은도서관,5000000,9000000,0,14000000
경북 포항시,구룡포읍민도서관,1560000,0,0,1560000
경북 군위군,군위군 새마을문고,4000000,0,4000000,8000000
경북 울진군,근남 작은도서관,1500000,19699840,9494160,30694000
경북 영주시,글마루,0,0,0,0
경북 구미시,글마루 새마을문고,1500000,0,900000,2400000
경북 고령군,금류새마을문고,0,0,0,0
경북 의성군,금성문고,0,0,0,0
경북 칠곡군,금암새마을작은도서관,0,0,0,0
경북 영천시,금창작은도서관,0,0,0,0
경북 영덕군,금호작은도서관,500000,0,500000,1000000
경북 포항시,기계면 버드내작은도서관,5000000,9169600,0,14169600
경북 울진군,기성작은도서관,1500000,21396000,10242000,33138000
경북 김천시,김산고을 작은도서관,8100000,9000000,4800000,21900000
경북 김천시,김천제일문고,300000,1200000,500000,2000000
경북 성주군,꿈과 쉼터,2000000,0,0,2000000
경북 김천시,꿈앤들 작은도서관,8100000,9000000,4800000,21900000
경북 고령군,꿈을 실은 도서관,0,0,0,0
경북 문경시,꿈을키우는문고,2500000,0,0,2500000
경북 칠곡군,남광새마을작은도서관,0,0,0,0
경북 봉화군,내일학교도서관,0,0,0,0
경북 포항시,농어촌두란노도서관,900000,0,0,900000
경북 영천시,늘푸른쉼터(아동도서실),0,0,145150,145150
경북 구미시,다봉새마을문고,2300000,0,100000,2400000
경북 의성군,다인문고,1000000,0,0,1000000
경북 영천시,단포작은도서관,2000000,12260000,115000,14375000
경북 김천시,달봉산 작은도서관,8100000,9000000,4800000,21900000
경북 칠곡군,대동다숲새마을작은도서관,3000000,0,10200000,13200000
경북 포항시,대명 작은도서관,0,0,0,0
경북 포항시,대송면 큰솔작은도서관,5000000,9000000,0,14000000
경북 칠곡군,대화새마을작은도서관,0,0,10700000,10700000
경북 포항시,대흥좋은나무도서관,8000000,0,0,8000000
경북 영천시,덕암문고,0,0,0,0
경북 경산시,도담도담작은도서관,30000000,10400000,9920000,50320000
경북 칠곡군,동명작은도서관,30000000,2604000,8630000,41234000
경북 문경시,동성마을문고,2000000,0,0,2000000
경북 포항시,동해사랑 작은도서관,900000,0,0,900000
경북 칠곡군,두성새마을작은도서관,0,0,300000,300000
경북 포항시,두호동 두무치작은도서관,5000000,9000000,0,14000000
경북 포항시,두호동 책이랑바다랑,5000000,9000000,0,14000000
경북 구미시,등대작은도서관,1200000,0,6000000,7200000
경북 구미시,뜨란채새마을문고,1000000,0,3326000,4326000
경북 의성군,르네상스문흥작은도서관,0,0,4418270,4418270
경북 안동시,마뜰작은도서관,0,0,0,0
경북 영천시,망정작은도서관,4000000,6500000,115000,10615000
경북 칠곡군,매원새마을작은도서관,300000,0,700000,1000000
경북 안동시,먼달작은도서관,3000000,200000,1953840,5153840
경북 영천시,무지개 작은 영어도서관,800000,0,300000,1100000
경북 영천시,문내행복도서관,0,0,0,0
경북 봉화군,물야면새마을문고,0,0,0,0
경북 봉화군,법전면새마을문고,0,0,0,0
경북 영천시,별빛문고,0,0,0,0
경북 영천시,별빛작은도서관,590000,0,330000,920000
경북 김천시,보랏빛꿈 작은도서관,8100000,9000000,4800000,21900000
경북 의성군,복사골 작은도서관,0,0,500000,500000
경북 봉화군,봉성면새마을문고,0,0,0,0
경북 봉화군,봉화읍새마을문고,500000,0,0,500000
경북 칠곡군,부영새마을 작은도서관,1300000,0,500000,1800000
경북 포항시,부조 작은도서관,1560000,0,0,1560000
경북 칠곡군,북삼삼주새마을작은도서관,2000000,6000000,2000000,10000000
경북 칠곡군,북삼새마을작은도서관,0,0,0,0
경북 칠곡군,북삼현대새마을작은도서관,1000000,0,38000000,39000000
경북 영천시,북안 버들숲 작은도서관,2000000,6150000,3544000,11694000
경북 포항시,브니엘 영어도서관,3000000,7200000,9000000,19200000
경북 경산시,사랑이 꽃피는 작은 도서관,100000,0,0,100000
경북 구미시,삼구트리니엔새마을작은도서관,0,0,0,0
경북 김천시,삼산이수 작은도서관,8100000,9000000,4800000,21900000
경북 칠곡군,삼성새마을작은도서관,0,0,0,0
경북 칠곡군,삼청새마을작은도서관,350000,5736000,914000,7000000
경북 포항시,상대동 큰섬마을작은도서관,5000000,9169600,0,14169600
경북 봉화군,상운면새마을문고,0,0,0,0
경북 의성군,새마을문고센터,2000000,0,0,2000000
경북 포항시,새벽이슬 작은도서관,300000,0,0,300000
경북 군위군,생각마루도서관,2000000,0,2400000,4400000
경북 영천시,서부동 작은도서관,1000000,0,0,1000000
경북 성주군,성주읍새마을문고,1140000,0,0,1140000
경북 구미시,소나무새마을문고,0,0,0,0
경북 구미시,소롯골 새마을문고,1567150,0,5972740,7539890
경북 포항시,송도동 솔향작은도서관,5000000,9169600,0,14169600
경북 영양군,수비면작은도서관,1000000,13920000,13525000,28445000
경북 고령군,숲속의옹달샘도서관,0,0,2000000,2000000
경북 포항시,신광면 비학산작은도서관,5000000,9000000,0,14000000
경북 구미시,신나리새마을문고,600000,0,1800000,2400000
경북 경산시,아가페문고,1000000,0,2000000,3000000
경북 구미시,아너스새마을문고,2000000,0,3000000,5000000
경북 경산시,아름드리도서관,0,0,30000,30000
경북 안동시,안동 옥동7주공 마을문고,3000000,0,0,3000000
경북 칠곡군,약목삼주새마을작은도서관,2700000,4850000,3290300,10840300
경북 칠곡군,약목새마을작은도서관,1000000,0,0,1000000
경북 경주시,양남 꿈마루 작은도서관,1000000,10425000,1624600,13049600
경북 경주시,양북 꿈마루 작은도서관,1000000,10425000,4288000,15713000
경북 포항시,양학동 부학작은도서관,5000000,9169600,0,14169600
경북 칠곡군,어울림새마을작은도서관,600000,0,600000,1200000
경북 구미시,에덴문고,2538040,0,894120,3432160
경북 포항시,연일읍 미르작은도서관,5000000,9000000,0,14000000
경북 포항시,연일읍 해돋이작은도서관,5000000,9000000,0,14000000
경북 영주시,영주상망작은도서관,10000000,9003500,2000000,21003500
경북 영주시,영주새마을문고,10600000,0,0,10600000
경북 영주시,영주휴천작은도서관,10000000,9003500,2000000,21003500
경북 구미시,예강문고,400000,0,2300000,2700000
경북 영덕군,예주작은도서관,4000000,0,0,4000000
경북 예천군,예천군새마을도서관,2000000,0,0,2000000
경북 칠곡군,오성새마을작은도서관,0,0,9900000,9900000
경북 포항시,오천읍 그루터기작은도서관,5000000,9000000,0,14000000
경북 포항시,오천읍 해와달작은도서관,5000000,9000000,0,14000000
경북 안동시,옥동삼성1차새마을문고,0,0,0,0
경북 울진군,온정작은도서관,1500000,21354000,10000000,32854000
경북 포항시,용흥동 솔개재작은도서관,5000000,9169600,0,14169600
경북 구미시,우림필유새마을문고,335460,0,1812600,2148060
경북 포항시,우방비치타운 도서실,0,0,0,0
경북 구미시,우방신세계문고,2177320,0,1644730,3822050
경북 칠곡군,우방신천지새마을작은도서관,1700000,9600000,2500000,13800000
경북 울진군,울진작은도서관,1500000,20766000,12697000,34963000
경북 울진군,원남작은도서관,1500000,19296000,8930000,29726000
경북 구미시,원평으뜸 작은도서관,5000000,14840000,13431000,33271000
경북 구미시,원호 대우 새마을 문고,2000000,0,2000000,4000000
경북 구미시,원호푸르지오새마을문고,0,0,3000000,3000000
경북 포항시,유강영어도서관,5000000,3200000,10800000,19000000
경북 경산시,은혜로도서관,3000000,0,2000000,5000000
경북 포항시,이팝문고,0,0,0,0
경북 김천시,일터누리 작은도서관,8100000,6000000,4800000,18900000
경북 김천시,자두꽃 작은도서관,8100000,9000000,4800000,21900000
경북 포항시,장량동 꿈마루 작은도서관,5000000,9000000,0,14000000
경북 포항시,장량동 다솜작은도서관,5000000,9000000,0,14000000
경북 포항시,장량동 참사랑작은도서관,5000000,9000000,0,14000000
경북 포항시,장량동 해뜰참 작은도서관,5000000,9000000,0,14000000
경북 포항시,장량동 햇살작은도서관,5000000,9000000,0,14000000
경북 구미시,장원새마을문고,0,0,0,0
경북 봉화군,재산작은도서관,0,0,0,0
경북 의성군,재활용센터문고,2000000,8400000,0,10400000
경북 구미시,점보 새마을작은도서관,0,0,0,0
경북 안동시,정하동화성드림파크작은도서관,0,1200000,0,1200000
경북 포항시,죽도동 맑은물작은도서관,5000000,9169600,0,14169600
경북 포항시,죽도동 청암작은도서관,5000000,9169600,0,14169600
경북 포항시,죽장면 선바위작은도서관,5000000,9000000,0,14000000
경북 포항시,죽장면 참느리 작은도서관,5000000,9000000,0,14000000
경북 칠곡군,지천면새마을문고 작은도서관,0,0,0,0
경북 경산시,진량작은도서관,30000000,1040000,5040000,36080000
경북 경산시,징검다리작은도서관,0,0,300000,300000
경북 영천시,창신푸른문고(푸른마을문고),0,0,0,0
경북 포항시,창포종합사회복지관 작은도서관,1560000,0,0,1560000
경북 경산시,책나무작은도서관,2000000,0,7500000,9500000
경북 성주군,천지빛깔,1500000,0,600000,2100000
경북 청송군,청경 작은 도서관,3400000,0,0,3400000
경북 청도군,청도작은도서관,2000000,16672000,29784000,48456000
경북 포항시,청림동 찬내작은도서관,5000000,9000000,0,14000000
경북 포항시,청림동 푸른숲작은도서관,5000000,9000000,0,14000000
경북 구미시,청마루문고,2000000,0,0,2000000
경북 예천군,청소년수련관내작은도서관,2500000,0,0,2500000
경북 청송군,청솔 작은도서관,9600000,0,4089000,13689000
경북 예천군,청운도서관,2000000,0,0,2000000
경북 포항시,청하면 해아작은도서관,5000000,9000000,0,14000000
경북 봉화군,춘양면새마을문고,0,0,0,0
경북 김천시,큰숲 작은도서관,8100000,9000000,4800000,21900000
경북 구미시,파라디아작은도서관,0,0,0,0
경북 구미시,파크 새마을작은도서관,1500000,0,500000,2000000
경북 울진군,평해작은도서관,1500000,19254000,10471000,31225000
경북 포항시,포항가은문고,0,0,0,0
경북 포항시,포항중앙도서관,6000000,0,0,6000000
경북 김천시,푸름찬 작은도서관,8100000,9000000,4800000,21900000
경북 예천군,풍양면 새마을문고,0,0,0,0
경북 포항시,하늘빛 마을문고,200000,16800000,0,17000000
경북 영천시,하늘소망문고,0,0,0,0
경북 안동시,하늘씨앗어린이도서관,3000000,17000000,2000000,22000000
경북 구미시,하늘채 새마을 문고,574300,0,2258400,2832700
경북 구미시,한누리새마을문고,1400000,0,1600000,3000000
경북 구미시,한빛새마을문고,0,0,0,0
경북 칠곡군,한빛새마을작은도서관,1000000,0,13000000,14000000
경북 영주시,한성문고,200000,0,0,200000
경북 칠곡군,한솔솔파크새마을작은도서관,1000000,0,800000,1800000
경북 영주시,한우리독서논술중앙지부,150000,0,0,150000
경북 영주시,한우리독서문화운동영주지부,250000,0,0,250000
경북 김천시,함께하는도서관,600000,0,1200000,1800000
경북 상주시,함창읍작은도서관,5000000,0,8920000,13920000
경북 포항시,해도동 바다섬작은도서관,5000000,9000000,0,14000000
경북 영덕군,해맑은작은도서관,0,0,200000,200000
경북 구미시,해평누리작은도서관,5000000,14840000,13431000,33271000
경북 경산시,헤세드문고,0,0,0,0
경북 경주시,현곡 꿈마루 작은도서관,1000000,10425000,1288000,12713000
경북 청송군,현서면 작은도서관,2000000,12000000,6160000,20160000
경북 칠곡군,혜원성모병원새마을작은도서관,0,0,0,0
경북 칠곡군,화성파크새마을작은도서관,700000,0,9000000,9700000
경북 포항시,환여 해맞이꿈터도서관,5000000,9000000,0,14000000
경북 포항시,환여동 환호어린이작은도서관,5000000,9000000,0,14000000
경북 포항시,효곡동 열린작은도서관,5000000,9000000,0,14000000
경북 포항시,효곡동 행복작은도서관,5000000,9000000,0,14000000
경북 포항시,효곡동그린숲작은도서관,5000000,9000000,0,14000000
경북 구미시,휴먼시아새마을문고,100000,0,500000,600000
경북 칠곡군,휴먼시아새마을작은도서관,100000,0,100000,200000
경북 영주시,휴천1동작은도서관,0,0,0,0
경북 포항시,흥해읍 내맏이작은도서관,5000000,9000000,0,14000000
경북 포항시,흥해읍 어리골작은도서관,5000000,9000000,0,14000000
경북 포항시,흥해읍 이팝작은도서관,5000000,9000000,0,14000000
경북 포항시,흥해읍 참새미 작은도서관,5000000,9000000,0,14000000
경북 문경시,흰종검글 마을도서관,2500000,18000000,500000,21000000
광주 남구,5.18민주인권작은도서관,500000,2500000,1500000,4500000
광주 남구,5단지솔빛작은도서관,5400000,4200000,6800000,16400000
광주 북구,CUM역사도서관,1200000,2400000,10000000,13600000
광주 북구,ESR작은도서관,3350000,23160000,3000000,29510000
광주 광산구,RIVER,0,0,0,0
광주 북구,가람문고,2000000,6000000,4000000,12000000
광주 북구,각화문고,0,0,0,0
광주 북구,강변문고,1000000,700000,0,1700000
광주 서구,강아지똥어린이도서관,4000000,7200000,1440000,12640000
광주 북구,개똥벌레어린이도서관,1000000,700000,1000000,2700000
광주 광산구,거성북카페,1200000,8400000,3000000,12600000
광주 남구,건강보험zone작은도서관,0,0,1000000,1000000
광주 서구,건강한 도서관,950000,0,1350000,2300000
광주 북구,건국작은도서관,300000,0,0,300000
광주 동구,계림두산위브작은도서관,2400000,3000000,3000000,8400000
광주 서구,고맙습니다 아리솔작은도서관,1400000,3000000,1100000,5500000
광주 북구,고맙습니다.두암3동 작은도서관,1977360,1940000,4070000,7987360
광주 광산구,광산문고,0,0,0,0
광주 서구,광주광역시청소년문화의집미소책방,1900000,0,0,1900000
광주 광산구,광주세계다문화,1000000,9600000,1000000,11600000
광주 북구,광주아름다운작은도서관,0,0,0,0
광주 광산구,광주유통센터,0,0,0,0
광주 서구,광주제일교회 도서관,4000000,8400000,0,12400000
광주 서구,광주천 사계 작은도서관,4400000,8000000,2400000,14800000
광주 서구,광천사랑숲 작은도서관,500000,0,0,500000
광주 동구,교육원도서관,2000000,15000000,1500000,18500000
광주 광산구,구름다리작은도서관,1800000,1200000,4000000,7000000
광주 북구,그리심작은도서관,6300000,0,0,6300000
광주 서구,글마루 작은도서관,500000,200000,100000,800000
광주 광산구,글마루작은도서관,0,3600000,0,3600000
광주 남구,금당작은도서관,0,0,0,0
광주 서구,금호2동 작은도서관,0,0,0,0
광주 서구,금호대우아파트 작은도서관,899910,1400000,0,2299910
광주 남구,기린작은도서관,3000000,3000000,24000000,30000000
광주 북구,기쁘고 즐거운 도서관,1000000,0,6000000,7000000
광주 서구,기아꿈터어린이도서관,2300000,12000000,1200000,15500000
광주 광산구,길북,250000,0,500000,750000
광주 서구,꾸니꾸니 꿈꾸는 작은도서관,1000000,0,3000000,4000000
광주 서구,꿈 일굼터 도서관,1400000,1400000,700000,3500000
광주 광산구,꿈꾸는 도서관,1000000,0,2000000,3000000
광주 북구,꿈꾸는 아이들,1000000,0,0,1000000
광주 북구,꿈나무도서관,0,0,0,0
광주 광산구,꿈나무도서관,0,0,0,0
광주 북구,꿈나무작은도서관,5000000,0,0,5000000
광주 광산구,꿈드림작은도서관,2266000,2900000,2362600,7528600
광주 광산구,꿈마루작은도서관,1000000,6000000,120000,7120000
광주 서구,꿈빛 도서관,1400000,0,2100000,3500000
광주 남구,꿈사랑작은도서관 ,600000,0,4200000,4800000
광주 북구,꿈이든 작은도서관,3000000,12000000,500000,15500000
광주 북구,꿈이있는작은도서관,170000,0,150000,320000
광주 남구,꿈이커가는봉선작은도서관,0,0,0,0
광주 광산구,꿈작은 도서관,3000000,0,0,3000000
광주 남구,꿈쟁이작은도서관,0,0,0,0
광주 광산구,꿈쟁이작은도서관,0,1200000,1200000,2400000
광주 남구,꿈트리작은도서관,0,0,0,0
광주 북구,꿈틀어린이 작은도서관,2000000,0,0,2000000
광주 광산구,나눔의집작은도서관,3500000,2350000,1750000,7600000
광주 광산구,나눔의집작은도서관,0,0,2500000,2500000
광주 서구,내방마루작은도서관,2500000,3600000,2000000,8100000
광주 북구,누리두리 작은도서관,500000,5000000,5000000,10500000
광주 북구,늘빛 작은도서관,280000,0,220000,500000
광주 광산구,늘푸른꿈,100000,0,300000,400000
광주 서구,늘푸른작은도서관,3000000,26000000,6000000,35000000
광주 광산구,늘푸른작은도서관,2000000,2000000,2000000,6000000
광주 북구,늘해랑 작은도서관,2000000,0,1200000,3200000
광주 북구,늘행복한작은도서관,4000000,6000000,5600000,15600000
광주 광산구,다사로움작은도서관,0,0,0,0
광주 북구,다솜울작은도서관,1600000,0,4550000,6150000
광주 광산구,다솜작은도서관,0,0,1000000,1000000
광주 북구,단비도서관,5200000,0,9426000,14626000
광주 남구,달뫼마을작은도서관,0,0,0,0
광주 동구,대안도서관틔움,2000000,0,5000000,7000000
광주 북구,대원작은도서관,0,0,0,0
광주 동구,대인작은도서관,100000,0,600000,700000
광주 서구,대주파크빌작은도서관,0,0,0,0
광주 광산구,더불어락작은도서관,3199300,0,0,3199300
광주 광산구,도깨비어린이도서관,3000000,2400000,7200000,12600000
광주 북구,도담도담어린이도서관,0,0,0,0
광주 광산구,도래샘작은도서관,1200000,4800000,3600000,9600000
광주 광산구,도산동문고,680000,4800000,4520000,10000000
광주 동구,동구문화센터작은도서관,2680000,4755310,2000000,9435310
광주 북구,동림동작은도서관,2096800,1860000,6330000,10286800
광주 북구,동림작은도서관,0,0,0,0
광주 북구,동이트는작은도서관,5000000,5400000,16350000,26750000
광주 서구,동천동작은도서관,1400000,0,0,1400000
광주 서구,동천마을6단지작은도서관,200000,900000,300000,1400000
광주 남구,두란노꿈나무작은도서관,0,0,450000,450000
광주 남구,두란노작은도서관,2200000,9000000,6400000,17600000
광주 서구,두란노작은도서관,1000000,6000000,12000000,19000000
광주 북구,두암1동작은도서관,1977360,1600000,3970000,7547360
광주 북구,두암문고,0,0,0,0
광주 남구,드림작은도서관,0,0,0,0
광주 북구,들꽃도서관,2800000,0,3750000,6550000
광주 북구,땅콩마당 작은도서관,0,0,0,0
광주 광산구,똥강아지어린이작은도서관,5000000,0,12000000,17000000
광주 남구,로뎀작은도서관,500000,5000000,240000,5740000
광주 남구,리움작은도서관,980000,0,2520000,3500000
광주 서구,마을도서관 다락,3000000,1200000,2000000,6200000
광주 광산구,마음영어도서관,0,0,5000000,5000000
광주 북구,마중물 작은도서관,1500000,0,8500000,10000000
광주 서구,만남작은도서관,900000,1000000,1500000,3400000
광주 광산구,맑은샘작은도서관,5000000,0,2400000,7400000
광주 북구,망월도서관,500000,0,1000000,1500000
광주 북구,매곡동작은도서관,297360,0,0,297360
광주 북구,매곡작은도서관,1200000,1400000,550000,3150000
광주 동구,메트로열린도서관,0,0,7000000,7000000
광주 남구,멘토링도서관,1200000,0,0,1200000
광주 북구,모해작은도서관,1000000,0,0,1000000
광주 광산구,목련마을작은도서관,3500000,0,3000000,6500000
광주 광산구,목련어울림,0,400000,100000,500000
광주 광산구,목우작은도서관,1000000,4000000,5000000,10000000
광주 서구,무등 작은도서관,1400000,1400000,700000,3500000
광주 남구,무등지역아동센터작은도서관,0,0,0,0
광주 광산구,무양서원,3000000,0,1500000,4500000
광주 북구,무지개 작은도서관,1400000,0,3850000,5250000
광주 남구,무지개문고,0,0,0,0
광주 북구,무진교육문화센터문고,500000,0,0,500000
광주 북구,문산 작은도서관,600000,10000000,1000000,11600000
광주 북구,문흥2동작은도서관,1937600,2200000,6280000,10417600
광주 북구,문흥골문고,330000,0,170000,500000
광주 북구,문흥작은도서관,1002360,1200000,197911,2400271
광주 남구,물빛공원작은도서관,2900000,7840000,7190000,17930000
광주 남구,미래작은도서관,0,0,0,0
광주 광산구,미래작은문고,1000000,0,4000000,5000000
광주 남구,민들레작은도서관,681000,2100000,2428596,5209596
광주 북구,바람개비문고,500000,0,1200000,1700000
광주 북구,밝은마음문고,0,0,0,0
광주 남구,방림2동작은도서관,1200000,11400000,7900000,20500000
광주 남구,방림휴먼시아 작은도서관,897400,0,2630000,3527400
광주 남구,방젯골어린이작은도서관,2000000,7001000,832330,9833330
광주 북구,배움 나무 작은도서관,1000000,0,6000000,7000000
광주 동구,백암문고,0,0,1000000,1000000
광주 남구,백운3반딧불작은도서관,700000,1600000,700000,3000000
광주 북구,백합 작은도서관,0,0,2000000,2000000
광주 서구,버들도서관,1400000,0,700000,2100000
광주 북구,벧엘작은도서관,100000,0,0,100000
광주 서구,복지도서관(푸른빛),0,0,0,0
광주 광산구,본량동작은도서관,0,0,0,0
광주 광산구,북마실&이레작은도서관,2000000,600000,500000,3100000
광주 동구,북카페 영어작은도서관,0,2000000,0,2000000
광주 남구,북카페작은도서관,1000000,0,1000000,2000000
광주 서구,브니엘문고,0,0,0,0
광주 광산구,비아까망이작은도서관,1000000,0,450000,1450000
광주 광산구,비전작은도서관,300000,2300000,700000,3300000
광주 북구,빛고을 두암문고,0,0,0,0
광주 서구,빛고을도서관,1000000,500000,500000,2000000
광주 남구,사과나무작은도서관,0,0,0,0
광주 북구,사랑나눔 작은도서관,1000000,500000,4800000,6300000
광주 광산구,사랑나눔작은도서관,5000000,1500000,2000000,8500000
광주 남구,사랑모아작은도서관,0,0,0,0
광주 북구,사랑의 문고,0,0,0,0
광주 북구,사랑의 카페,0,0,0,0
광주 광산구,사랑의문고,0,0,0,0
광주 남구,사랑작은도서관,900000,4080000,1520000,6500000
광주 남구,사랑하는사람들,0,0,0,0
광주 북구,사임당작은도서관,1000000,1400000,200000,2600000
광주 남구,사직문고,0,0,800000,800000
광주 동구,산수중앙작은도서관,850000,600000,1800000,3250000
광주 광산구,산정작은도서관,100000,0,1000000,1100000
광주 북구,삼각동작은도서관,1737360,0,2760000,4497360
광주 남구,상록문고,0,0,2200000,2200000
광주 서구,상무작은도서관,700000,0,0,700000
광주 광산구,상정쉼마루작은도서관,0,0,200000,200000
광주 광산구,새로운작은도서관,500000,0,2500000,3000000
광주 남구,새마을작은도서관,0,0,14514540,14514540
광주 광산구,새물결작은도서관,520000,0,1200000,1720000
광주 북구,새생명작은도서관,300000,0,0,300000
광주 북구,새싹을의글방 두암2동작은도서관,1977360,1940000,4170000,8087360
광주 북구,새싹작은도서관,3800000,18000000,1200000,23000000
광주 북구,새에덴 작은도서관,0,0,0,0
광주 남구,샘물작은도서관,400000,10000000,5000000,15400000
광주 광산구,샘솟는 작은도서관,0,0,3000000,3000000
광주 북구,생각나무작은도서관,3300000,3300000,3300000,9900000
광주 남구,생각쟁이작은도서관,1000000,0,1500000,2500000
광주 북구,생명의강작은도서관,1000000,0,0,1000000
광주 서구,서광작은도서관,1400000,0,700000,2100000
광주 북구,서림마을 작은도서관,10000000,0,10000000,20000000
광주 북구,서머힐 지역문고,0,0,0,0
광주 서구,서문작은도서관,1000000,0,2000000,3000000
광주 광산구,선암작은도서관,0,0,1100000,1100000
광주 광산구,선운한마음작은도서관,1000000,600000,1500000,3100000
광주 북구,성은작은도서관,0,600000,500000,1100000
광주 북구,세계로문고,1000000,1000000,3000000,5000000
광주 광산구,세리작은도서관,250000,0,500000,750000
광주 남구,세움작은도서관,0,0,0,0
광주 서구,소꿉놀이작은도서관,4200000,7200000,10560000,21960000
광주 남구,소망나눔문고,0,0,0,0
광주 북구,소피움웃음꽃도서관,2000000,6000000,7000000,15000000
광주 광산구,솔로몬작은도서관,0,0,240000,240000
광주 광산구,솟대작은도서관,500000,200000,1700000,2400000
광주 광산구,송광나눔드리작은도서관,0,0,500000,500000
광주 남구,송암문고,0,0,0,0
광주 북구,송운작은도서관,0,0,0,0
광주 광산구,송정작은도서관,0,51167000,13658000,64825000
광주 서구,송촌파인힐아파트 작은도서관,4400000,0,3371000,7771000
광주 남구,송화6단지작은도서관,0,0,0,0
광주 남구,송화7단지작은도서관,630000,0,3870000,4500000
광주 남구,송화마을3단지작은도서관,500000,3780000,720000,5000000
광주 광산구,수완1단지중흥S클래스,2500000,3200000,100000,5800000
광주 광산구,수완1차부영아파트 작은도서관,0,0,0,0
광주 광산구,수완1차우미린문고,0,7920000,0,7920000
광주 광산구,수완2차우미린문고,0,4200000,0,4200000
광주 광산구,수완세영리첼,0,500000,0,500000
광주 광산구,수완코롱하늘채어린이문고,1200000,4000000,300000,5500000
광주 광산구,수완피오레문고,1200000,0,0,1200000
광주 광산구,수완현진에버빌2단지,4000000,4800000,2000000,10800000
광주 광산구,수완호반베르디움 1차,0,3000000,0,3000000
광주 광산구,수자인문고,0,0,0,0
광주 남구,순돌이네책방작은도서관,0,0,0,0
광주 남구,숲속작은도서관,700000,1750000,420000,2870000
광주 남구,쉴만한물가,0,1800000,2500000,4300000
광주 남구,쉴휴 작은도서관,200000,1300000,0,1500000
광주 서구,쉼 북카페 도서관,0,0,0,0
광주 광산구,쉼 작은도서관,500000,300000,1200000,2000000
광주 북구,시냇가작은도서관,0,0,0,0
광주 광산구,신가부영아파트 문고,1600000,4800000,0,6400000
광주 북구,신광작은도서관,0,0,0,0
광주 북구,신안동작은도서관,1977440,1840000,4020000,7837440
광주 북구,신용작은도서관,3000000,7000000,1000000,11000000
광주 북구,신원작은도서관문고,1000000,0,100000,1100000
광주 북구,신일작은도서관,1050000,700000,0,1750000
광주 서구,신천힐탑작은도서관,1400000,700000,700000,2800000
광주 남구,실버작은도서관,7200000,2280000,600000,10080000
광주 북구,아델리움2단지 작은도서관,3300000,2100000,1600000,7000000
광주 광산구,아름골작은도서관,0,0,0,0
광주 광산구,아름도서관,3000000,0,0,3000000
광주 북구,아이꿈어린이도서관,0,5000000,18000000,23000000
광주 서구,아이숲어린이도서관,2000000,7200000,5000000,14200000
광주 남구,아이자람문고,0,0,0,0
광주 동구,알암인권작은도서관,197000,750000,5053000,6000000
광주 북구,앰플작은도서관,1000000,0,200000,1200000
광주 서구,양동 작은도서관,5000000,2000000,7530000,14530000
광주 서구,양동문고,2400000,3600000,300000,6300000
광주 북구,양산작은도서관,0,0,0,0
광주 남구,양지작은도서관,4490000,0,10847400,15337400
광주 남구,어린왕자힐링작은도서관,600000,840000,1860000,3300000
광주 동구,어울매작은도서관,1000000,0,3100000,4100000
광주 북구,에덴작은도서관,1000000,0,0,1000000
광주 북구,에이스문고,1000000,1400000,200000,2600000
광주 서구,여성친화 휴(休) 도서관,1000000,0,15143000,16143000
광주 북구,여우고개어린이문고,0,0,1100000,1100000
광주 북구,연꽃못작은도서관,0,0,110000,110000
광주 북구,연제신안작은도서관,1000000,0,500000,1500000
광주 북구,연제큰꿈작은도서관문고,1800000,5600000,1960000,9360000
광주 광산구,열린도서관,0,0,0,0
광주 서구,열린작은도서관,900000,0,1400000,2300000
광주 북구,영락작은도서관,1060000,9600000,0,10660000
광주 광산구,영천주공10단지,0,0,0,0
광주 북구,예그리나 작은도서관,0,0,500000,500000
광주 광산구,예다음,0,0,240000,240000
광주 북구,예은작은도서관,1000000,0,0,1000000
광주 서구,예일작은도서관,1000000,5000000,1500000,7500000
광주 북구,예향문고,0,0,0,0
광주 동구,오색종이신나는작은도서관,3500000,15000000,2500000,21000000
광주 남구,오손도손작은도서관,0,0,0,0
광주 북구,오치 세우는 작은도서관,3297330,7900000,2994600,14191930
광주 북구,오치1동꿈나무작은도서관,1997360,1940000,3950000,7887360
광주 북구,오치2동작은도서관,1977360,1510000,3920000,7407360
광주 광산구,옹기종기작은도서관,0,0,0,0
광주 동구,옹달샘작은도서관,1500000,0,900000,2400000
광주 북구,용두작은도서관,300000,0,200000,500000
광주 북구,용봉쌍용작은도서관,0,0,0,0
광주 북구,용봉작은도서관,2811360,26721800,11976000,41509160
광주 북구,용봉주공 작은도서관,0,0,0,0
광주 광산구,용아,0,0,0,0
광주 남구,우리동네작은도서관,0,0,0,0
광주 서구,우리들의 쉼터 작은도서관,3000000,0,1000000,4000000
광주 광산구,우리작은도서관,0,0,0,0
광주 광산구,우산동작은도서관,3200000,3000000,6131250,12331250
광주 광산구,우제작은도서관,2300000,0,5000000,7300000
광주 북구,우치작은도서관,1600000,17000000,8000000,26600000
광주 광산구,우하하사람책도서관,5000000,6000000,1200000,12200000
광주 광산구,운남삼성작은도서관,2000000,6000000,300000,8300000
광주 북구,운암1동큰꿈작은도서관,3940000,0,2760000,6700000
광주 북구,운암2동 작은도서관,4430000,0,1120000,5550000
광주 북구,운암3동황계작은도서관,4356800,1960000,3970000,10286800
광주 북구,운암작은도서관,300000,3000000,4000000,7300000
광주 서구,운천골 작은도서관,1000000,0,1000000,2000000
광주 광산구,원당숲어울마루작은도서관,1000000,1600000,6000000,8600000
광주 광산구,월곡동행복도서관,4000000,0,9792310,13792310
광주 서구,월광교회도서관,5298455,5010000,3588880,13897335
광주 광산구,월광비젼작은도서관 ,3000000,600000,1200000,4800000
광주 남구,월산5동 작은도서관,7630000,5600000,9800000,23030000
광주 남구,월산상록작은도서관,1000000,1000000,4000000,6000000
광주 남구,월산작은도서관,0,0,0,0
광주 남구,월산지역아동작은도서관,0,0,0,0
광주 북구,율곡작은도서관,1000000,0,0,1000000
광주 광산구,은빛마을도서관,1900000,4140000,500000,6540000
광주 동구,은새암,2600000,3700000,8600000,14900000
광주 북구,은혜작은도서관,0,0,2000000,2000000
광주 광산구,이룸작은도서관,1420000,0,0,1420000
광주 북구,임동뜨란채희망도서관,1600000,800000,1920000,4320000
광주 북구,임동청소년문고,500000,500000,500000,1500000
광주 광산구,잉계마을애작은도서관,0,0,1000000,1000000
광주 북구,자우리작은도서관,2000000,0,1500000,3500000
광주 광산구,자이안센터문고,0,7200000,14000000,21200000
광주 동구,작은도서관숲,2000000,6000000,2000000,10000000
광주 광산구,장공도서관,1000000,0,1200000,2200000
광주 서구,좋은씨앗 작은도서관,1700000,7200000,2600000,11500000
광주 남구,좋은친구작은도서관,0,0,100000,100000
광주 북구,주나작은도서관,800000,0,0,800000
광주 북구,주민작은도서관,2400000,8400000,5500000,16300000
광주 북구,주안문고,1000000,0,0,1000000
광주 서구,중앙나누리작은도서관,1400000,1400000,700000,3500000
광주 북구,중앙동작은도서관,297760,0,0,297760
광주 북구,중흥1동작은도서관,2227440,0,1120000,3347440
광주 북구,중흥작은도서관,1700000,3560000,11411000,16671000
광주 동구,지산2동작은도서관,3062000,3711750,2000000,8773750
광주 동구,지원2동작은도서관,2068000,58320210,2000000,62388210
광주 동구,지원꿈꾸는작은도서관,0,0,0,0
광주 광산구,지혜로움,0,0,0,0
광주 광산구,지혜의샘,500000,0,10800000,11300000
광주 서구,지혜의샘 도서관,1500000,0,580000,2080000
광주 서구,지혜의샘터,0,0,2000000,2000000
광주 남구,진월작은도서관,4242000,15730000,10028000,30000000
광주 북구,징검다리작은도서관,3640000,0,560000,4200000
광주 광산구,참빛작은도서관,0,0,0,0
광주 북구,참터문고,600000,3000000,600000,4200000
광주 서구,책 더하기 사랑 도서관,2000000,2100000,3100000,7200000
광주 북구,책과 벗하는 사랑방,0,0,1250000,1250000
광주 북구,책돌이도서관,5000000,1440000,22130832,28570832
광주 서구,책마을작은도서관,300000,0,1000000,1300000
광주 남구,책문화공간봄작은도서관,0,1750000,2000000,3750000
광주 서구,책사랑작은도서관,0,0,0,0
광주 광산구,책으로만나는세상,2500000,0,6000000,8500000
광주 북구,책향기작은도서관,1000000,1000000,1000000,3000000
광주 북구,천재작은도서관,1000000,0,2150000,3150000
광주 광산구,철쭉작은도서관,0,0,0,0
광주 광산구,첨단나눔드리책방,0,0,0,0
광주 광산구,첨단라인1차작은도서관,0,0,0,0
광주 광산구,첨단문고,0,0,0,0
광주 광산구,첨단빛누리 작은도서관,0,20000000,15000000,35000000
광주 북구,첨단자이2단지 작은도서관,2344000,0,1706000,4050000
광주 북구,친환경도서관버스,4500000,2000000,1800000,8300000
광주 남구,코끼리작은도서관,1500000,12000000,8000000,21500000
광주 북구,콩세알작은도서관,4400000,3500000,12100000,20000000
광주 북구,큰꿈도서관문고,500000,0,0,500000
광주 북구,큰숲 작은도서관,200000,0,640000,840000
광주 광산구,키움,3000000,1000000,0,4000000
광주 북구,탈무드작은도서관,50000,950000,0,1000000
광주 남구,파란꿈작은도서관,0,0,0,0
광주 광산구,파란나라,1000,4800,1200,7000
광주 동구,파이디온작은도서관,550000,12000000,6000000,18550000
광주 동구,푸른길 기차 도서관,1500000,1290000,1070000,3860000
광주 남구,푸른길작은도서관,2400000,8400000,5200000,16000000
광주 동구,푸른길책향기작은도서관,0,1600000,7816000,9416000
광주 북구,푸른꿈문고,0,0,0,0
광주 북구,푸른샘작은도서관,0,0,2400000,2400000
광주 북구,푸른숲 작은도서관,0,0,0,0
광주 북구,푸른숲작은도서관,1695800,4300000,4800000,10795800
광주 동구,풀꽃동산작은도서관,1000000,4440000,4000000,9440000
광주 남구,풀꽃작은도서관,2694000,2310000,900000,5904000
광주 북구,풍성한작은도서관,1200000,1200000,4800000,7200000
광주 서구,풍암전원작은도서관,0,0,0,0
광주 북구,풍향동작은도서관,3937440,0,560000,4497440
광주 광산구,하남2지구중흥s클래스,0,0,0,0
광주 광산구,하남문고,0,0,0,0
광주 남구,하늘꿈작은도서관,0,0,0,0
광주 북구,하늘사랑 작은도서관,5000000,0,3000000,8000000
광주 동구,학2마을작은도서관,0,1100000,1400000,2500000
광주 동구,학동두란노작은도서관,0,0,0,0
광주 동구,학운동작은도서관,2660000,55137340,2000000,59797340
광주 북구,한마음문고,2000000,2200000,1000000,5200000
광주 서구,한별지혜의샘작은도서관,0,0,0,0
광주 광산구,한울문고,4000000,3500000,534350,8034350
광주 서구,해돋는작은도서관,500000,0,0,500000
광주 광산구,해솔마을작은도서관,5000000,0,0,5000000
광주 광산구,햇살 도서관,0,0,0,0
광주 북구,햇살마루작은도서관,1920000,1200000,5880000,9000000
광주 북구,행복나무작은도서관,1500000,8400000,1200000,11100000
광주 서구,행복도서관,3000000,19200000,1600000,23800000
광주 광산구,행복도서관,0,0,8400000,8400000
광주 북구,행복한작은도서관,0,0,0,0
광주 동구,행복한작은문고,2400000,0,0,2400000
광주 북구,향기문고,1500000,0,1500000,3000000
광주 서구,향기작은도서관,0,0,0,0
광주 북구,현진에버빌작은도서관,1200000,0,0,1200000
광주 광산구,혜윰마루작은도서관,3000000,0,4073000,7073000
광주 광산구,호반꿈마루작은도서관,0,0,0,0
광주 서구,호반베르디움 작은도서관,1000000,0,3000000,4000000
광주 광산구,호반풀잎작은도서관,3000000,2400000,0,5400000
광주 광산구,홀리트리교육지원센터협동조합작은도서관,0,900000,150000,1050000
광주 서구,화정4동 작은 도서관,1400000,0,7000000,8400000
광주 서구,화정문고,1500000,0,7200000,8700000
광주 남구,효덕동작은도서관,7630000,5600000,9800000,23030000
광주 광산구,희망도서관,0,3600000,4100000,7700000
광주 북구,희망드림교실작은도서관,0,0,0,0
광주 남구,희망작은도서관,1000000,1100000,0,2100000
광주 남구,흰구름작은도서관,0,0,0,0
대구 중구,(사)청소년 교육문화센터 우리세상,3870000,10000000,8000000,21870000
대구 북구,U대회선수촌2단지도서관,3600000,7200000,600000,11400000
대구 달성군,가창면 참꽃작은도서관,5000000,37601950,10925740,53527690
대구 달서구,감삼영어도서관,8000000,12000000,6000000,26000000
대구 북구,겨자씨도서관,500000,1000000,500000,2000000
대구 수성구,고산작은도서관,15,40,65,120
대구 북구,고성동도서관,2500000,15000000,7780000,25280000
대구 달성군,구지면작은도서관,8840000,14281000,18210000,41331000
대구 달서구,그루터기어린이도서관,2200000,1200000,9600000,13000000
대구 달서구,글 향기 작은 도서관,2400000,0,3600000,6000000
대구 북구,글벗작은도서관,5000000,3000000,2500000,10500000
대구 수성구,꿈가득 도서관,250000,0,0,250000
대구 북구,꿈꾸는 도서관,1000000,0,2400000,3400000
대구 달성군,꿈꾸는작은도서관,3295120,0,632829,3927949
대구 달서구,꿈꾸는책나라도서관,0,0,0,0
대구 남구,꿈나무 영어도서관,1200000,2400000,6500000,10100000
대구 동구,꿈나무작은도서관,0,0,0,0
대구 동구,꿈날자도서관,3000000,0,2000000,5000000
대구 동구,꿈또리도서관,6296630,0,548670,6845300
대구 달서구,꿈에 그린 작은도서관,0,0,0,0
대구 북구,꿈이 있는 도서관,0,0,600000,600000
대구 남구,꿈이커가는도서관,2000000,15000000,8400000,25400000
대구 남구,꿈틀작은도서관,5000000,24575000,5425000,35000000
대구 중구,남산4동 작은도서관,3709600,0,3464720,7174320
대구 중구,남산그린새마을문고,0,1400000,100000,1500000
대구 중구,남산기독교종합사회복지관 작은도서관,2500000,0,1375000,3875000
대구 중구,남산다락골 작은도서관,2998230,0,981700,3979930
대구 중구,남산휴먼시아 2단지 마을도서관,2000000,3000000,1000000,6000000
대구 중구,남산휴먼시아1단지 마을문고,0,0,0,0
대구 서구,내당4동어린이도서관,3000000,0,1000000,4000000
대구 북구,노원동도서관,2500000,15000000,3300000,20800000
대구 달성군,논공읍작은도서관,0,37968000,1661150,39629150
대구 동구,느티나무작은도서관,0,0,0,0
대구 수성구,늘빛 작은 도서관,0,0,0,0
대구 수성구,늘빛 작은도서관,0,0,0,0
대구 동구,늘푸른도서관,2500000,0,1159600,3659600
대구 달성군,다사e편한세상문고,0,12000000,1200000,13200000
대구 달성군,다사읍 서재작은도서관,8840000,14281000,6300000,29421000
대구 달성군,다사읍작은도서관,5000000,14200000,0,19200000
대구 달성군,다사파피루스,6000000,18000000,2400000,26400000
대구 달성군,달성군청 도서관,20000000,32825000,12160000,64985000
대구 달성군,달성군청소년센터 작은도서관,4749480,25800000,0,30549480
대구 달성군,대곡역래미안 열린도서관,709080,0,916170,1625250
대구 달서구,대곡역파크드림도서관,5111540,0,4400153,9511693
대구 남구,대구다문화어린이도서관 '모두',2500000,22000000,0,24500000
대구 중구,대구시청 작은도서관,36000000,80000000,25000000,141000000
대구 중구,대구제이교회 작은도서관,200000,0,300000,500000
대구 중구,대구중구영어도서관,12000000,21679000,12649000,46328000
대구 중구,대신동작은도서관,4000000,3800000,0,7800000
대구 북구,대현e.편한세상작은도서관,2400000,0,1200000,3600000
대구 북구,대현뜨란채도서관,0,0,514000,514000
대구 북구,대현휴도서관,2000000,0,400000,2400000
대구 동구,도평동작은도서관,0,0,0,0
대구 수성구,동광독서문화원,0,0,1200000,1200000
대구 동구,동구청 작은도서관,0,0,0,0
대구 중구,동인 느티나무 도서관,2200000,26772000,10216000,39188000
대구 동구,동촌역사 작은도서관,0,0,0,0
대구 달서구,동한문화센터,1250000,0,0,1250000
대구 동구,돼지등 마을문고,0,0,8000000,8000000
대구 달서구,두산미소도서관,2000000,0,3240000,5240000
대구 서구,마을도서관햇빛따라,4015987,15240000,14367215,33623202
대구 서구,만평주민도서관,2000000,0,6346386,8346386
대구 북구,매화작은도서관,3600000,6000000,1000000,10600000
대구 북구,메르디앙 작은도서관,150000,0,150000,300000
대구 북구,무지개 작은도서관,3500000,1000000,11300000,15800000
대구 중구,문화의집 작은도서관,0,0,0,0
대구 수성구,민들레 문고,0,0,0,0
대구 수성구,바이링구도서관,2000000,2400000,3000000,7400000
대구 동구,반야월 행복한 어린이도서관 아띠,3300000,1500000,10434000,15234000
대구 동구,반야월새싹문고,2500000,1500000,2000000,6000000
대구 동구,반야월역사작은도서관,0,0,0,0
대구 동구,방촌동작은도서관,0,0,0,0
대구 동구,방촌어린이도서관,3000000,0,1000000,4000000
대구 수성구,범물동 작은도서관,100,0,50,150
대구 수성구,봄동 작은도서관,0,0,0,0
대구 북구,북구어린이도서관,11288127,40356230,12855095,64499452
대구 수성구,북성어린이도서관,0,0,0,0
대구 동구,불로어울림 작은도서관,0,0,0,0
대구 서구,비산7동 작은도서관,2000000,3600000,4688000,10288000
대구 수성구,비전숲작은도서관,30,0,50,80
대구 달성군,사랑나누기도서관,2500000,7200000,6000000,15700000
대구 동구,사랑의 문고,1000000,0,0,1000000
대구 수성구,사월역도서관,8000000,6240000,5176000,19416000
대구 동구,살비도서관,1200000,0,1200000,2400000
대구 동구,살비도서관,120,0,120,240
대구 달서구,삼성명가타운작은도서관,3600000,0,0,3600000
대구 달서구,상인역e.편한세상마을문고,3000000,0,0,3000000
대구 달서구,상인청구마을문고,0,0,0,0
대구 서구,새마을문고대구서구지부작은도서관,3000000,11000000,31266020,45266020
대구 달서구,새하늘 작은도서관,1164840,0,100480,1265320
대구 수성구,생각을 키우는 도서관,500000,0,3600000,4100000
대구 서구,서구청 작은도서관,2000000,0,500000,2500000
대구 달성군,서재우방타운문고,0,0,0,0
대구 수성구,선한이웃 작은도서관,2517800,2900000,503000,5920800
대구 북구,성광우방타운 주민도서실,1800000,0,0,1800000
대구 달서구,성당포스코the #도서관,2300000,0,680000,2980000
대구 달서구,성당하늘채도서관,3000000,0,500000,3500000
대구 수성구,성덕 영혼의샘터 도서관,6600000,1200000,4200000,12000000
대구 중구,성지문고,0,0,0,0
대구 달서구,소망의친구들도서관,3500000,0,1200000,4700000
대구 달서구,솔고개작은도서관,1252350,0,1500000,2752350
대구 수성구,수성코오롱하늘채도서실,0,800000,0,800000
대구 수성구,술술어린이도서,2500000,0,2342000,4842000
대구 수성구,신동산문고,0,0,0,0
대구 동구,신암2동작은도서관,0,0,0,0
대구 동구,신암3동작은도서관,0,0,0,0
대구 동구,신암5동 작은도서관(새마을문고),3587000,21519000,15378000,40484000
대구 동구,신암청아람문고,0,0,0,0
대구 동구,신천3동(고맙습니다)작은도서관,0,0,0,0
대구 동구,신천어울림도서관,0,0,150000,150000
대구 북구,신평교회 작은도서관,300000,0,0,300000
대구 북구,아름다운 작은도서관,1000000,0,500000,1500000
대구 수성구,아름다운 창대문고,0,0,0,0
대구 북구,아이비티주니어 영어작은도서관,2000000,4800000,9078370,15878370
대구 동구,아힘나도서관,500000,1200000,300000,2000000
대구 달서구,양현문고,6000000,0,12000000,18000000
대구 달성군,엔젤문고,1000000,0,9000000,10000000
대구 수성구,엘림 작은도서관,500000,0,500000,1000000
대구 달서구,여명주민도서실,2500000,14760000,7200000,24460000
대구 북구,영어도서관 E&C도서관,3600000,15000000,6000000,24600000
대구 달서구,예가도서관,1250000,0,1200000,2450000
대구 중구,오월애 나눔도서관,0,0,0,0
대구 서구,옹달샘작은도서관,1141000,12000000,4000000,17141000
대구 달서구,용산1동작은도서관,11379970,0,17345580,28725550
대구 달서구,웃는얼굴아트센터 도서실,7294570,15964050,2216500,25475120
대구 달서구,월배힐스테이트(반딧불)도서관,6080660,0,3600000,9680660
대구 달서구,월성e-편한세상 작은도서관,3600000,2640000,2620000,8860000
대구 달서구,월성도서관,1000000,15000000,20000000,36000000
대구 달서구,월성월드메르디앙도서관,5100000,0,3600000,8700000
대구 달서구,월성코오롱하늘채1단지도서관,6799290,0,4686470,11485760
대구 달서구,월성푸르지오책마루도서관,8500000,0,2650000,11150000
대구 달성군,유가면작은도서관,42000000,15450000,0,57450000
대구 달서구,유천 포스코 더샵 마을문고,1878400,0,2021600,3900000
대구 동구,율하5주민도서관,3000000,0,456000,3456000
대구 달서구,이곡2동도서실,23144770,11390640,5390440,39925850
대구 달서구,이곡책나무도서관,0,0,6000000,6000000
대구 달서구,이레도서관,1000000,2400000,1800000,5200000
대구 동구,이야기보따리,500000,0,9000000,9500000
대구 동구,이야기영어도서관,6000000,0,8000000,14000000
대구 남구,이천행복작은도서관,4500000,0,0,4500000
대구 남구,작은나눔문화재단나눔도서관,2000000,2000000,2000000,6000000
대구 북구,작은도서관 수인제,50000,0,200000,250000
대구 달서구,작은빛 도서관,1500000,5000000,5000000,11500000
대구 달서구,작은숲도서관,3000000,0,5000000,8000000
대구 남구,작은숲영어도서관,1000000,0,0,1000000
대구 북구,작은인문학도서관 고인돌,500000,1000000,5000000,6500000
대구 달서구,장기동작은도서관,11397480,3600000,712270,15709750
대구 달성군,죽곡휴먼시아1단지 도서실,2000000,0,0,2000000
대구 달서구,죽전동공립작은도서관,3764210,2880000,1895450,8539660
대구 중구,중구청교양정보실,8000000,37069920,2650000,47719920
대구 수성구,지산영어도서관,3800000,27200000,1200000,32200000
대구 동구,지저동작은도서관,0,0,0,0
대구 동구,책나무 도서관,350000,0,5300000,5650000
대구 수성구,책나무 만촌,3000000,0,12000000,15000000
대구 수성구,책나무 수성1점,500000,0,15000000,15500000
대구 수성구,책나무 수성점,300,0,1200,1500
대구 북구,책나무 작은도서관(서변동),50000,0,900000,950000
대구 수성구,책나무 지산점,1200000,0,1650000,2850000
대구 수성구,책나무도서관,1000000,0,1500000,2500000
대구 북구,책나무도서관,5000000,15000000,13200000,33200000
대구 달서구,책나무도서관,400000,0,10780000,11180000
대구 달성군,책나무도서관,4500000,0,3740000,8240000
대구 북구,책나무작은도서관(동천동),3000000,0,12000000,15000000
대구 북구,책나무작은도서관(복현동),100000,0,700000,800000
대구 북구,책마실 작은도서관,5000000,0,12000000,17000000
대구 달서구,책먹는여우도서관,8000000,5000000,10000000,23000000
대구 수성구,책비말글교육원,6000000,6840000,2400000,15240000
대구 달서구,책으로 꿈꾸는 작은도서관,2088900,0,5453500,7542400
대구 수성구,천성지혜의자리,1000000,0,500000,1500000
대구 남구,청개구리작은도서관,500000,0,0,500000
대구 북구,청소년 밝은세상 비전문고,0,0,0,0
대구 동구,초록우산도서관,3500000,0,6329450,9829450
대구 북구,칠곡그린빌4단지 도서실,1167330,4200000,1238618,6605948
대구 북구,칠성휴먼시아 작은도서관,1000000,0,1200000,2200000
대구 달서구,캐슬도서관,2000000,0,1000000,3000000
대구 북구,코오롱하늘채2단지 작은도서관,5000000,2500000,500000,8000000
대구 달서구,코오롱하늘채2단지문고,2300000,0,300000,2600000
대구 수성구,코이디아도서관,0,0,0,0
대구 수성구,큰숲도서관,100,0,0,100
대구 북구,태전1동 공립 작은도서관,2903020,10000000,308850,13211870
대구 동구,파란마음동산문고,500000,0,1200000,1700000
대구 동구,평강작은도서관,0,0,0,0
대구 달성군,푸르지오도서관,90500,1810000,1099500,3000000
대구 달서구,푸른하늘영어도서관,3461250,0,8268670,11729920
대구 달서구,하늘향기충성가족도서관,3000000,0,6000000,9000000
대구 수성구,하담 작은도서관,0,0,0,0
대구 북구,하람어린이도서관,840000,0,0,840000
대구 달성군,하빈면작은도서관,42000000,15450000,0,57450000
대구 동구,해바라기도서관,2500000,0,0,2500000
대구 동구,해안동작은도서관,0,0,0,0
대구 동구,해피트리도서관,0,0,0,0
대구 동구,행복도서관,3353100,4800000,1241420,9394520
대구 달서구,행복충전소도서관,3051500,0,6919100,9970600
대구 수성구,행복한 영어도서관,1000000,4800000,8000000,13800000
대구 달서구,행정정보문고센터,8320000,0,5658000,13978000
대구 북구,향기가있는 열린공간 부엉이,0,0,0,0
대구 북구,화성그랜드 함지원도서관,1200000,3600000,0,4800000
대구 달성군,화성문고,0,0,0,0
대구 북구,화성센트럴파크 도서관,1200000,7000000,200000,8400000
대구 달서구,화성파크리젠시도서관,1180000,2200000,920000,4300000
대구 달성군,화원읍작은도서관,8860000,28557000,46550000,83967000
대구 달성군,화진금봉타운문고,0,0,0,0
대구 수성구,황금도서관,0,0,0,0
대구 동구,효목1동작은도서관,0,0,0,0
대구 동구,효목2동작은도서관,0,0,0,0
대구 수성구,후마네르범어도서관,5000000,24000000,7000000,36000000
대전 서구,갈마마을어린이도서관땅콩,3320000,0,10000000,13320000
대전 동구,강아지똥작은도서관,0,0,0,0
대전 유성구,골목길 작은도서관 읽새,4000000,0,8000000,12000000
대전 중구,공익문고풀뿌리아카이브,0,0,0,0
대전 동구,광제사 작은도서관,1200000,0,0,1200000
대전 유성구,그린문고(대덕테크노10단지),2400000,0,0,2400000
대전 유성구,글결고운나래도서관,2000000,0,0,2000000
대전 중구,글마루도서관,1800000,0,0,1800000
대전 유성구,금성문고,500000,0,500000,1000000
대전 중구,금호새마을문고,1800000,0,200000,2000000
대전 중구,깊은산속 옹달샘,0,0,0,0
대전 중구,꾸러기 도서관,600000,0,400000,1000000
대전 대덕구,꾸러기어린이도서관,7100000,0,6800000,13900000
대전 서구,꿈꾸는도서관,1890000,0,0,1890000
대전 서구,꿈땅명성도서관,4000000,0,1500000,5500000
대전 대덕구,꿈사랑작은도서관,5000000,0,400000,5400000
대전 유성구,꿈샘 작은 도서관,2000000,0,1000000,3000000
대전 유성구,꿈에 그린 문고,2700000,0,1500000,4200000
대전 동구,꿈에그린마을금고,1875000,0,0,1875000
대전 동구,꿈이있는문고,0,0,0,0
대전 서구,꿈쟁이작은도서관,1890000,7800000,7189632,16879632
대전 동구,꿈터도서관,1200000,0,0,1200000
대전 서구,꿈터마을어린이도서관,2870000,0,9600000,12470000
대전 서구,나눔의 도서관 ( 아가페),2000000,0,3600000,5600000
대전 중구,남대전푸른문고,120000,0,200000,320000
대전 서구,내동 작은나무 마을어린이 도서관,2870000,0,1050000,3920000
대전 서구,내동영명도서관,2019310,0,1163500,3182810
대전 유성구,노은1동 작은도서관,1412000,0,2640000,4052000
대전 중구,늘푸른도서관,0,0,0,0
대전 중구,늘푸른도서관,2000000,0,0,2000000
대전 동구,달콤한책,1875000,0,0,1875000
대전 서구,달팽이어린이도서관,2870000,0,7200000,10070000
대전 유성구,대덕테크노밸리 2단지 문고,2500000,0,0,2500000
대전 유성구,대덕테크노밸리3단지도서실(대덕테크노3단지문고),100000,0,50000,150000
대전 유성구,대덕테크노밸리5단지 문고,2515370,0,1400000,3915370
대전 유성구,대덕테크노밸리6단지문고(운암네오미아 어린이문고),2400000,0,0,2400000
대전 유성구,대덕테크노밸리7단지도서관,2325000,0,0,2325000
대전 중구,대전다문화아동센터？도서관,6000000,1000000,12000000,19000000
대전 중구,대전문화별찌작은도서관,1500000,2800000,1350000,5650000
대전 동구,대주파크빌 작은도서관,1200000,0,0,1200000
대전 대덕구,대창무지개도서관,3400000,7200000,800000,11400000
대전 대덕구,대화동작은도서관,1000000,1500000,0,2500000
대전 대덕구,대화마을도서관,2500000,0,1000000,3500000
대전 중구,대흥마을문고,3820,0,1200,5020
대전 유성구,덕명도서관 마음터,1200000,0,600000,1800000
대전 대덕구,덕암동작은도서관,1000000,1500000,0,2500000
대전 서구,도마2동새마을문고,1890000,0,0,1890000
대전 서구,도마마을문고,0,0,1200000,1200000
대전 중구,돌다리작은도서관(석교동마을문고),5020000,0,0,5020000
대전 동구,동대전작은도서관,1200000,0,0,1200000
대전 동구,동산메빅문고,0,0,0,0
대전 서구,동서남Book작은도서관,980000,0,2250000,3230000
대전 유성구,동화마을 작은도서관,13000000,0,20000000,33000000
대전 동구,두란노작은도서관,1875000,0,0,1875000
대전 대덕구,둥근빛작은도서관,2500000,0,1350000,3850000
대전 유성구,드림월드문고,3500000,0,0,3500000
대전 대덕구,또바기어린이도서관,4600000,0,6900000,11500000
대전 유성구,뜰안문고(테크노4단지),3000000,0,2000000,5000000
대전 서구,로뎀도서관,1579080,0,2400000,3979080
대전 동구,로뎀작은도서관,0,0,0,0
대전 대덕구,루터도서관,1000000,0,1200000,2200000
대전 대덕구,마루도서관,3450000,4800000,2100000,10350000
대전 대덕구,만두레작은도서관,2000000,0,1000000,3000000
대전 중구,맑은샘도서관(문화2동마을문고),3580000,0,1440000,5020000
대전 서구,메아리작은도서관,1890000,300000,150000,2340000
대전 유성구,모퉁이어린이도서관,850,0,17199,18049
대전 중구,목동 마을문고,5020000,0,0,5020000
대전 중구,목동어린이도서관,1500000,0,1500000,3000000
대전 대덕구,목상동작은도서관,3500000,0,1500000,5000000
대전 중구,문창동마을문고,4261000,0,759000,5020000
대전 중구,문창비젼문고,0,0,0,0
대전 중구,문화1동마을문고,4657000,0,363000,5020000
대전 중구,문화작은도서관,5000000,0,5000000,10000000
대전 서구,미래를여는도서관,6700000,0,1600000,8300000
대전 서구,미래작은도서관,1900000,4000000,2400000,8300000
대전 유성구,반석마을1단지문고,0,2000000,0,2000000
대전 유성구,반석마을3단지아파트도서관,0,0,0,0
대전 유성구,반석마을4단지문고,0,0,0,0
대전 유성구,반석마을6단지문고,1200000,0,600000,1800000
대전 유성구,반석마을7단지문고,600000,0,0,600000
대전 유성구,반석마을8단지문고,0,0,100000,100000
대전 서구,방주문고,1890000,0,0,1890000
대전 서구,백운꿈의도서관,3830320,0,0,3830320
대전 중구,버드내작은도서관(유천2동마을문고),4592000,0,528000,5120000
대전 대덕구,법1동작은도서관,3500000,1500000,0,5000000
대전 대덕구,법2동작은도서관,1000000,0,1500000,2500000
대전 서구,보물단지 작은도서관,1400000,0,26000000,27400000
대전 서구,복된꿈이있는 도서관,2500000,0,0,2500000
대전 중구,복된문고,0,0,500000,500000
대전 중구,부사동 마을문고,3520000,0,1500000,5020000
대전 대덕구,비래동작은도서관,1000000,0,1500000,2500000
대전 유성구,쁘레네 작은도서관 별찌,2000000,0,10000000,12000000
대전 중구,사랑의 문고,0,0,600000,600000
대전 동구,산내문고,1200000,0,0,1200000
대전 중구,산성마을문고,4162000,0,858000,5020000
대전 서구,새누리도서관,1890000,0,0,1890000
대전 동구,새들뫼휴먼시아1단지아파트 작은도서관,2400000,0,0,2400000
대전 서구,새로운문고,2500000,0,600000,3100000
대전 유성구,새마을문고유성구지부,3500000,0,1780000,5280000
대전 중구,새마음작은도서관,0,0,0,0
대전 동구,샘골마을문고,0,0,0,0
대전 대덕구,석봉동작은도서관,3200000,3600000,2400000,9200000
대전 대덕구,석봉동작은도서관(공립),1000000,0,1500000,2500000
대전 유성구,석지도서관,3300000,0,12000000,15300000
대전 대덕구,선비2단지작은도서관,2500000,0,871470,3371470
대전 대덕구,선비4단지작은도서관,3600000,0,2400000,6000000
대전 서구,선진MBL문고,100000,0,2000000,2100000
대전 동구,성남공부방,1875000,0,0,1875000
대전 중구,성락작은도서관,0,1584000,264100,1848100
대전 중구,성민도서관,0,0,0,0
대전 유성구,성지제일도서관,0,0,0,0
대전 중구,센트럴파크2단지문고,958230,4800000,273110,6031340
대전 유성구,소담도서문화센터,1200000,0,0,1200000
대전 유성구,송강마을 작은도서관,13000000,0,20000000,33000000
대전 유성구,송강테크노도서관,6000000,0,0,6000000
대전 유성구,송림마을2단지(행복도서관),2600000,0,0,2600000
대전 유성구,송림마을3단지문고,3500000,4800000,0,8300000
대전 대덕구,송촌동작은도서관,5400000,0,0,5400000
대전 대덕구,송촌마을문고,3250000,0,550000,3800000
대전 서구,수목토아파트작은도서관,1890000,565940,100000,2555940
대전 서구,수밋들어린이 도서관,1890000,8893420,941400,11724820
대전 유성구,숲속의 글마루,4200000,1440000,0,5640000
대전 중구,쉴만한물가문고,50000,0,0,50000
대전 동구,스마트뷰아파트 작은도서관,0,0,0,0
대전 유성구,스마트작은도서관,2400000,9000000,4600000,16000000
대전 유성구,신성마을 작은도서관,13000000,0,20000000,33000000
대전 동구,신일작은도서관,1875000,0,0,1875000
대전 대덕구,신탄진동작은도서관,5000000,1500000,0,6500000
대전 서구,썬샤인문고,0,0,0,0
대전 유성구,아름다운도서관(송림마을5단지),0,0,250000,250000
대전 서구,아이사랑영어도서관,2000000,6000000,2000000,10000000
대전 동구,아침마을작은도서관,2400000,0,0,2400000
대전 중구,알짬마을도서관,4130000,1600000,11954101,17684101
대전 동구,어깨동무마을어린이도서관,1200000,0,0,1200000
대전 중구,어린이 미래도서관,1000000,0,1000000,2000000
대전 중구,어린이책 읽새 골목길 작은도서관,8000000,7000000,10000000,25000000
대전 유성구,어울림 하트도서관,1080000,0,0,1080000
대전 중구,열두광주리어린이도서관,0,0,0,0
대전 서구,영광사립문고,1890000,0,6000000,7890000
대전 유성구,예미지문고,0,3960000,240000,4200000
대전 대덕구,예성도서관,2000000,3600000,2000000,7600000
대전 서구,예수마을문고,862540,0,0,862540
대전 중구,예인회책방,0,0,0,0
대전 중구,오류동 삼성아파트도서관,3744770,0,433451,4178221
대전 중구,오류동마을문고,4310000,0,0,4310000
대전 대덕구,오정동작은도서관,4400000,0,1500000,5900000
대전 대덕구,오정북카페,1000000,0,1000000,2000000
대전 유성구,온천마을 작은도서관 ,13000000,0,20000000,33000000
대전 유성구,옹달샘작은도서관,1500000,0,0,1500000
대전 중구,용두동 마을문고,4000000,0,1020000,5020000
대전 대덕구,용전작은도서관,3500000,0,500000,4000000
대전 서구,우리동네작은도서관,500000,0,1000000,1500000
대전 동구,우리문고,1200000,0,0,1200000
대전 유성구,우림문고(테크노12단지),1200000,0,0,1200000
대전 유성구,원신흥동어린이도서관,0,0,0,0
대전 유성구,위즈덤하우스,1000000,2000000,7000000,10000000
대전 중구,유천어린이도서관,500000,0,3600000,4100000
대전 중구,은행선화동마을문고,4572900,0,447100,5020000
대전 대덕구,자람자람작은도서관,2000000,0,1000000,3000000
대전 유성구,자운마을 작은도서관,13000000,0,20000000,33000000
대전 유성구,전민가족도서관,12000000,0,0,12000000
대전 중구,주안문고,0,0,0,0
대전 대덕구,중리동작은도서관,1000000,1500000,0,2500000
대전 중구,중촌동마을문고,5020000,0,0,5020000
대전 중구,중촌마을어린이도서관'짜장',3200000,13000000,5000000,21200000
대전 중구,짝꿍마을어린이도서관,2898000,4000000,8695710,15593710
대전 대덕구,차오름어린이도서관,2000000,0,3000000,5000000
대전 동구,창대문고,1200000,0,0,1200000
대전 유성구,천양원문고,3000000,0,0,3000000
대전 서구,천일월드빌아파트 작은도서관,1890000,1200000,213000,3303000
대전 중구,청춘 책방 '책 한그릇',1000010,0,1418300,2418310
대전 대덕구,초록우산도서관,1115000,0,4084000,5199000
대전 동구,큰빛문고,1875000,0,0,1875000
대전 유성구,탄허불교도서관,0,0,0,0
대전 중구,태평1동 마을문고,3520000,0,1500000,5020000
대전 유성구,트리풀시티아파트문고,200,0,0,200
대전 서구,파렌하이트아파트작은도서관,3600000,12000000,1000000,16600000
대전 서구,평강장로교회문고,1890000,0,0,1890000
대전 동구,푸른꿈도서관,1875000,0,0,1875000
대전 중구,푸른솔문고,50000,0,0,50000
대전 유성구,한라비발디아파트문고,0,1200000,0,1200000
대전 중구,한마음문고,200000,0,7000000,7200000
대전 서구,한빛도서관,1890000,12600000,8111000,22601000
대전 유성구,한빛문고,9000000,0,0,9000000
대전 서구,한우리독서문화원,1000000,0,6000000,7000000
대전 중구,한우리독서운동본부,1560000,0,0,1560000
대전 서구,해뜰마을어린이도서관,2800000,0,7200000,10000000
대전 중구,해바라기문고,0,0,0,0
대전 유성구,행복한 작은 도서관,2000000,0,500000,2500000
대전 동구,행복한도서관,1200000,0,0,1200000
대전 동구,호숫가마을어린이도서관,1200000,0,0,1200000
대전 대덕구,회덕동작은도서관,1000000,1500000,0,2500000
대전 대덕구,회덕작은도서관,2500000,0,0,2500000
대전 유성구,희망마을 작은도서관,13000000,0,20000000,33000000
부산 기장군,EG글숲,9500000,0,0,9500000
부산 남구,LG메트로작은쌈지도서관,5600000,0,10480000,16080000
부산 수영구,e-편한세상 작은도서관,1000000,1000000,0,2000000
부산 중구,？다 작은도서관,2000000,68250000,34853000,105103000
부산 해운대구,가람뫼푸른꿈작은도서관,0,0,3600000,3600000
부산 남구,감만꿈터,1000000,0,509000,1509000
부산 남구,감만독서문화원,1200000,0,2400000,3600000
부산 사하구,감천횃불작은도서관,4375000,4962875,11605000,20942875
부산 연제구,거제2동새마을문고작은도서관,5000000,17269430,16710000,38979430
부산 사상구,고맙습니다 보물섬 작은도서관,600000,9400000,6800000,16800000
부산 중구,고맙습니다.글마루작은도서관,5000000,78498660,33895240,117393900
부산 기장군,고촌휴먼시아아파트 새마을문고,10000000,0,3000000,13000000
부산 사하구,괴정3동 작은도서관,3000000,11200000,2440000,16640000
부산 금정구,구서작은도서관,1700000,0,100000,1800000
부산 동래구,그루터기 작은도서관,0,0,0,0
부산 강서구,극동스타클래스작은도서관,2000000,0,0,2000000
부산 금정구,글누리작은도서관,1300000,1000000,3600000,5900000
부산 동래구,글로벌 영어 작은도서관,10000000,8700000,1400000,20100000
부산 금정구,금샘마을도서관,1800000,8400000,6960000,17160000
부산 금정구,금정문고,1200000,0,0,1200000
부산 금정구,금정산 SK VIEW 북카페,3500000,6000000,0,9500000
부산 사하구,까치마을작은도서관,5000000,28800000,7700000,41500000
부산 수영구,깔깔도서관,1200000,2400000,480000,4080000
부산 서구,꽃마을 작은도서관,900000,2400000,3190730,6490730
부산 해운대구,꽃마을작은도서관,0,0,2400000,2400000
부산 동래구,꿈꾸는 도서관,0,0,0,0
부산 영도구,꿈나무 작은도서관,0,0,0,0
부산 금정구,꿈드림 작은도서관,7000000,0,9595000,16595000
부산 남구,꿈드림 작은도서관,0,0,0,0
부산 서구,꿈사다리 도서관,1000000,0,0,1000000
부산 기장군,꿈사랑 작은도서관,4900000,0,5876000,10776000
부산 남구,꿈샘작은도서관,1000000,0,0,1000000
부산 사하구,꿈이 자라는 신평작은도서관,9000000,7200000,1400000,17600000
부산 남구,꿈이 자라는 작은도서관,0,0,200000,200000
부산 수영구,꿈자람 작은도서관,300000,0,100000,400000
부산 남구,꿈자람터 작은도서관,1200000,1400000,1000000,3600000
부산 해운대구,나눔작은도서관,2000000,0,4500000,6500000
부산 부산진구,나드림작은도서관,820000,300000,2720060,3840060
부산 북구,남산정 작은도서관,2000000,0,1000000,3000000
부산 수영구,남천천신협작은도서관,4000000,9600000,12000000,25600000
부산 영도구,남항작은도서관,1000000,0,1300000,2300000
부산 사하구,노을나루길작은도서관,3000000,11440000,2000000,16440000
부산 해운대구,뉴라이프,0,1000000,5400000,6400000
부산 사상구,늘소망 작은도서관,1000000,0,400000,1400000
부산 수영구,늘푸른 도서관,2000000,0,1000000,3000000
부산 북구,늘푸른도서관,300000,0,1500000,1800000
부산 사하구,다대2동 작은도서관,3000000,11440000,1440000,15880000
부산 사하구,다모아작은도서관,3000000,0,5000000,8000000
부산 영도구,다문화 어린이 도서관'모두',1178000,16904000,5300000,23382000
부산 사상구,다문화도서관,500000,0,40000,540000
부산 해운대구,다비다 도서관,0,0,0,0
부산 연제구,다원문고,0,0,0,0
부산 서구,닥밭골 작은 도서관,1000000,10000000,3400000,14400000
부산 해운대구,달맞이도서관,0,6000000,2000000,8000000
부산 기장군,달산누리,30000000,200000,3000000,33200000
부산 부산진구,달팽이작은도서관,1200000,0,360000,1560000
부산 부산진구,당감1동작은도서관,30000000,0,70000000,100000000
부산 부산진구,당감2동새마을문고,1000000,0,1200000,2200000
부산 부산진구,당감뜨란채 작은도서관,1000000,2000000,2000000,5000000
부산 사하구,당리작은도서관,4375000,4962875,11605000,20942875
부산 사하구,당리푸르지오 푸른나무도서관,0,0,1200000,1200000
부산 북구,대림작은도서관,7920000,0,6000000,13920000
부산 금정구,대우도서실,4000000,4200000,1800000,10000000
부산 동구,더나눔작은도서관,0,18000000,45500000,63500000
부산 북구,덕천문고,0,0,0,0
부산 동래구,동래 작은도서관,0,0,0,0
부산 사하구,동매누리 작은도서관,4375000,4962875,11605000,20942875
부산 서구,동서남-BOOK 작은도서관,2000000,0,2000000,4000000
부산 영도구,동일도서관,0,0,0,0
부산 남구,동항작은도서관,500000,0,0,500000
부산 북구,동화와 시,0,0,0,0
부산 남구,들꽃이야기 작은도서관,1200000,21600000,9600000,32400000
부산 수영구,디딤돌작은도서관,6160000,0,0,6160000
부산 남구,로뎀나무 아래 작은 도서관,0,0,300000,300000
부산 기장군,롯데캐슬2차 북돋음터,0,40000,60000,100000
부산 수영구,르네상스 작은도서관,1800000,0,3600000,5400000
부산 기장군,리슈빌도서관,0,0,0,0
부산 강서구,링컨타운책벌레작은도서관,0,4200000,0,4200000
부산 동구,마실작은도서관,2000000,0,2100000,4100000
부산 사하구,마하골 길벗 작은도서관,4375000,4962875,11605000,20942875
부산 금정구,머드레작은도서관,1426000,1500000,3074000,6000000
부산 동래구,명륜도서관,0,0,0,0
부산 동래구,명륜동 새마을문고,1500000,0,0,1500000
부산 사하구,명성도서관,0,0,0,0
부산 동래구,명장2동 새마을문고,1500000,0,0,1500000
부산 사상구,모라1동 작은도서관,5000000,0,0,5000000
부산 사하구,모모작은도서관,13000000,3600000,4920000,21520000
부산 부산진구,몬테소리작은도서관,500000,4800000,2400000,7700000
부산 사하구,몰운대그린비치아파트 작은도서관,0,400000,0,400000
부산 해운대구,무정도서관,8152900,5280000,198100,13631000
부산 사하구,무지개 작은도서관,4375000,4962875,11605000,20942875
부산 남구,문현마을문고,32000,16080000,600000,16712000
부산 연제구,물만골,0,0,0,0
부산 해운대구,미리내 작은도서관,0,0,0,0
부산 금정구,미리내작은도서관,5000000,18982000,8891000,32873000
부산 중구,민들레작은도서관,2336000,0,474000,2810000
부산 수영구,바람길작은도서관,1000000,0,1000000,2000000
부산 해운대구,바퀴달린 그림책 작은도서관,1200000,1200000,1800000,4200000
부산 해운대구,반송2동새마을작은도서관,2600000,0,4000000,6600000
부산 해운대구,반송문고,0,0,0,0
부산 해운대구,반송온누리교회작은도서관,0,0,0,0
부산 해운대구,반여 꿈꾸는 어린이 도서관,0,0,0,0
부산 해운대구,반여1동새마을작은도서관,3914000,0,0,3914000
부산 해운대구,반여2동새마을작은도서관,2300000,0,0,2300000
부산 해운대구,반여3동새마을작은도서관,2300000,0,0,2300000
부산 해운대구,반여4동새마을작은도서관,2700000,0,0,2700000
부산 연제구,배산작은도서관,4000000,13799000,16710000,34509000
부산 동구,범일프로버 도서관,0,0,600000,600000
부산 부산진구,범천작은도서관,4000000,1200000,500000,5700000
부산 동래구,법륜지혜 작은도서관,0,0,0,0
부산 중구,보수동책방골목어린이도서관,16000000,48000000,12160000,76160000
부산 동래구,복산동 새마을문고,750000,0,0,750000
부산 서구,부민작은도서관,8120000,9600000,2100000,19820000
부산 동래구,부산 작은도서관,0,1440000,1530000,2970000
부산 부산진구,부산광역시교육청 작은도서관,9902390,0,1740600,11642990
부산 부산진구,부산시사립문고회문고,1500000,4800000,1600000,7900000
부산 남구,부산시여성회관 작은도서관,5000000,0,0,5000000
부산 연제구,부산의료원 작은도서관,2000000,0,1000000,3000000
부산 부산진구,부산진사립문고협회 문고,1500000,4800000,1600000,7900000
부산 부산진구,부암3동작은도서관,0,1000000,475000,1475000
부산 동래구,북돋움 작은도서관,360000,0,4000000,4360000
부산 사하구,북세통(book을 통한 세상과의 소통),0,0,174000,174000
부산 남구,북조아 작은 도서관,0,0,0,0
부산 해운대구,북카페 하늘정원,0,0,0,0
부산 남구,브니엘 학습관 문고,0,0,200000,200000
부산 부산진구,비발디작은도서관(2012.4.27 등록),1084470,0,455440,1539910
부산 부산진구,비전도서관,5000000,0,600000,5600000
부산 해운대구,비전작은도서관,0,0,0,0
부산 사하구,사랑나눔 작은도서관,3500000,0,400000,3900000
부산 부산진구,사랑방마실,30000000,1600000,19187000,50787000
부산 북구,사랑의 문고,0,0,0,0
부산 동래구,사랑의샘 작은도서관,1000000,0,1300000,2300000
부산 사상구,사상 작은도서관,4923530,38622600,14707990,58254120
부산 동래구,사직1동 새마을문고,1500000,0,0,1500000
부산 동래구,사직3동 새마을문고,1500000,0,0,1500000
부산 사하구,사하마을문고,0,0,0,0
부산 남구,산성교회문고,1000000,9000000,6000000,16000000
부산 사하구,새벗작은도서관,1000000,12000000,6000000,19000000
부산 사하구,새사랑 작은 도서관,2000000,0,200000,2200000
부산 해운대구,새소망작은도서관,2000000,0,3600000,5600000
부산 남구,샘터꿈의도서관,3500000,9000000,4700000,17200000
부산 남구,샘터작은도서관,3000000,0,0,3000000
부산 서구,서구문화원작은도서관,2000000,0,16000000,18000000
부산 금정구,서동골책놀이터문고,2100000,0,4200000,6300000
부산 금정구,서동작은도서관,4150000,0,0,4150000
부산 기장군,서연관,433700,0,500000,933700
부산 기장군,서희스타힐스작은도서관,0,3600000,102430,3702430
부산 동래구,센터럴파크 작은도서관,0,6600000,1800000,8400000
부산 기장군,센트럴작은도서관,0,0,0,0
부산 금정구,소정꿈나무작은도서관,1100000,0,0,1100000
부산 남구,솔로몬 도서관,1500000,0,500000,2000000
부산 서구,송도바다 작은도서관,0,0,0,0
부산 서구,송도제일교회문고,3000000,0,1000000,4000000
부산 해운대구,송정2휴먼시아작은도서관,0,0,1200000,1200000
부산 해운대구,송정도서관,0,0,0,0
부산 동구,수정중앙문고,0,0,0,0
부산 부산진구,숨바꼭질 작은도서관,2000000,0,3000000,5000000
부산 해운대구,스위첸작은도서관,0,0,0,0
부산 강서구,시민책방작은도서관,17000000,6000000,17000000,40000000
부산 북구,시온성 작은도서관,5571530,0,2815580,8387110
부산 부산진구,신개금엘지작은도서관,371900,550000,244200,1166100
부산 기장군,신동아파밀리에도서실,500000,0,1900000,2400000
부산 해운대구,신일 꿈나무 작은도서관,0,0,0,0
부산 사하구,신평꿈꾸는작은도서관,4375000,4962875,11605000,20942875
부산 해운대구,아이를사랑하는작은도서관,5000000,0,2000000,7000000
부산 연제구,아이마루 작은도서관,300000,7000000,14000000,21300000
부산 강서구,아인슈타인타운책벌레작은도서관,500000,0,500000,1000000
부산 동래구,안락2동 새마을문고,0,0,0,0
부산 부산진구,양정2동작은도서관,0,650000,1350000,2000000
부산 해운대구,어깨동무책방,0,0,0,0
부산 서구,어린왕자 작은도서관,7000000,21000000,10500000,38500000
부산 서구,어린이&가족도서관 꿈꾸는 글나라,2400000,18000000,0,20400000
부산 부산진구,어린이도서관동화랑놀자,6000000,8400000,3600000,18000000
부산 서구,어울림 작은도서관,900000,2500000,0,3400000
부산 영도구,어울림마당작은도서관,3300000,0,1000000,4300000
부산 해운대구,어진이작은도서관,0,0,229000,229000
부산 사상구,엄궁 쌈지 작은도서관,5500000,0,1000000,6500000
부산 강서구,에디슨타운책벌레작은도서관,2000000,0,1000000,3000000
부산 사하구,에코작은도서관,4500000,0,6720000,11220000
부산 연제구,연산3동 새마을문고 밤골 작은도서관,4000000,17269430,16710000,37979430
부산 연제구,연산4동새마을문고해뜰작은도서관,8815500,24000000,1472450,34287950
부산 연제구,연제가족도서원,600000,0,800000,1400000
부산 부산진구,연지동작은도서관(2012.9.6 개관),2000000,1000000,500000,3500000
부산 사상구,열린 작은도서관,0,0,0,0
부산 부산진구,열린도서관,2500000,8400000,1200000,12100000
부산 부산진구,열린문도서관,1000000,0,2400000,3400000
부산 영도구,영선2동 풀잎작은도서관,500000,0,550000,1050000
부산 기장군,예닮책마을,600000,0,600000,1200000
부산 금정구,예일솔로몬문고,1100000,0,0,1100000
부산 북구,오뚜기 작은도서관,2000000,0,1000000,3000000
부산 사하구,옥토어린이문고,500000,0,0,500000
부산 동래구,온고지신 작은도서관,1000000,0,21644000,22644000
부산 동래구,온천1동 새마을문고,1425000,0,0,1425000
부산 동래구,온천2동 새마을문고,1500000,0,0,1500000
부산 해운대구,우1동새마을작은도서관,2300000,0,1100000,3400000
부산 연제구,우리동네작은도서관,1200000,12700000,10596000,24496000
부산 사하구,원더풀 작은도서관,0,0,0,0
부산 연제구,월드메르디앙 작은도서관,0,4800000,120000,4920000
부산 금정구,유니세프 작은도서관,5000000,18982000,8891000,32873000
부산 북구,율리작은도서관,500000,0,0,500000
부산 사하구,은항쉐마도서관,3000000,4800000,1800000,9600000
부산 영도구,은혜도서관,2000000,0,1000000,3000000
부산 금정구,이야기동동 작은도서관,2000000,0,1000000,3000000
부산 기장군,이진캐스빌블루1차,8600000,0,1000000,9600000
부산 연제구,인문학 북카페 동행,0,0,850000,850000
부산 동래구,인성 작은도서관,1000000,2400000,3000000,6400000
부산 동래구,일곱빛깔 작은도서관,0,0,0,0
부산 동래구,일희망 작은도서관,2000000,0,1000000,3000000
부산 남구,작은나무숲,1200000,0,3600000,4800000
부산 부산진구,작은도서관 꿈자람,1200000,3440000,1000000,5640000
부산 남구,작은여울 도서관,500000,0,2400000,2900000
부산 해운대구,작은인문학도서관,20672190,7500000,3997580,32169770
부산 해운대구,재반작은도서관,1200000,3600000,14400000,19200000
부산 해운대구,재송1동새마을작은도서관,2300430,0,0,2300430
부산 해운대구,재송2동새마을작은도서관,2600000,0,0,2600000
부산 영도구,절영 작은도서관,5000000,18000000,6000000,29000000
부산 기장군,정관동일2차 북카페,20000000,0,80000,20080000
부산 기장군,정관휴먼시아2단지 작은도서관,0,50000,50000,100000
부산 해운대구,좌1동새마을작은도서관,2300000,0,6000000,8300000
부산 해운대구,좌2동새마을작은도서관,4760000,0,2914310,7674310
부산 해운대구,좌3동새마을작은도서관,2800000,0,3200000,6000000
부산 해운대구,좌4동새마을작은도서관,2400000,0,0,2400000
부산 사상구,주례쌈지작은도서관,5000000,0,1500000,6500000
부산 해운대구,중1동새마을작은도서관,2600000,0,0,2600000
부산 해운대구,지식의 창고 작은도서관,0,82000,960000,1042000
부산 금정구,지혜의 샘,1000000,0,0,1000000
부산 부산진구,지혜의 샘 문고,0,0,3600000,3600000
부산 서구,짬짬이 작은도서관,579800,2386500,0,2966300
부산 부산진구,찬누리작은도서관,5000000,500000,500000,6000000
부산 남구,참사랑도서관,0,0,0,0
부산 중구,책갈피 작은도서관,2005530,0,994470,3000000
부산 강서구,책나무 작은도서관,2000000,0,1000000,3000000
부산 남구,책나무그늘,2367860,4000000,2485340,8853200
부산 남구,책나무그늘 작은도서관,2367860,4000000,2485340,8853200
부산 사상구,책누리작은도서관,4200000,0,240000,4440000
부산 부산진구,책마루작은도서관,3130190,10733000,32649000,46512190
부산 동래구,책마을 작은도서관,8008000,0,3792000,11800000
부산 영도구,책바다작은도서관,4200000,0,240000,4440000
부산 서구,책사랑작은도서관,1000000,2400000,600000,4000000
부산 해운대구,책사랑작은도서관,0,0,0,0
부산 금정구,책읽는 세상,1000000,0,0,1000000
부산 해운대구,천초작은도서관,564540,4100000,10910000,15574540
부산 기장군,청강책쉼터,0,0,0,0
부산 남구,청소년쉼터도서관,2400000,0,9000000,11400000
부산 동구,초량중앙문고,0,0,0,0
부산 사하구,초록꿈 작은도서관,3000000,0,0,3000000
부산 동구,초록우산 어린이북카페,2895290,21362720,5797790,30055800
부산 서구,초장동꿈터작은도서관,1000000,0,2000000,3000000
부산 기장군,칠암작은도서관,0,0,0,0
부산 사하구,큰마루 공부방,3600000,6960000,3440000,14000000
부산 금정구,큰뿌리독서원,200000,0,400000,600000
부산 서구,포도나무 도서관,1000000,0,7200000,8200000
부산 사하구,푸른누리작은도서관,4375000,4962875,11605000,20942875
부산 강서구,하늘나무작은도서관,0,0,696000,696000
부산 사하구,하단쉼터 도서관,0,0,0,0
부산 부산진구,한국독서대학도서관,1000000,2000000,3000000,6000000
부산 기장군,한빛책나눔터,0,0,0,0
부산 영도구,한울마당 작은도서관,0,0,5304870,5304870
부산 사상구,한울타리 작은도서관,0,0,0,0
부산 사상구,함께하는 작은도서관,0,0,0,0
부산 기장군,해모로도서관,5197290,0,3974260,9171550
부산 해운대구,해운대세계작은도서관,10500000,20470850,3689950,34660800
부산 해운대구,해운어린이작은도서관,0,500000,0,500000
부산 사상구,햇살나무작은도서관,2400000,12000000,9500000,23900000
부산 사하구,행복나눔 작은도서관,0,0,0,0
부산 사하구,행복나무 작은도서관,0,0,3000000,3000000
부산 부산진구,행복마을작은도서관,3000000,1200000,500000,4700000
부산 중구,행복이가득한도서관,0,0,0,0
부산 기장군,행복작은도서관,0,0,0,0
부산 남구,행복한 문고,0,0,0,0
부산 서구,향기나는 작은도서관,900000,17159300,0,18059300
부산 기장군,현진에버빌 Book-Caf？,200000,100000,200000,500000
부산 영도구,홀리조이작은도서관,500000,0,300000,800000
부산 북구,화명수목원 숲속 작은도서관,0,0,0,0
부산 북구,화명종합사회복지관 어린이도서관,2267430,5983500,5148330,13399260
부산 사하구,회화나무작은도서관,4375000,4962875,11605000,20942875
부산 부산진구,훈민정음작은도서관,1000000,3000000,12000000,16000000
부산 기장군,휴먼시아1단지 책사랑문고,0,0,0,0
부산 해운대구,희망풍차작은도서관,1000000,0,0,1000000
서울 은평구,6단지 상림문고,3868130,0,874240,4742370
서울 서대문구,DMC래미안e편한세상아파트 1블럭작은도서관,2710002,3370940,4220000,10300942
서울 서대문구,DMC래미안e편한세상아파트 2블럭작은도서관,2712000,3370940,4220000,10302940
서울 서대문구,DMC래미안e편한세상아파트 3블럭작은도서관,2712000,3370940,4220000,10302940
서울 송파구,KSPO수영장도서관,6000000,0,7000000,13000000
서울 서초구,LH서초3단지 행복도서관,0,0,0,0
서울 서초구,LH서초4단지 작은도서관,100000,0,500000,600000
서울 강북구,cms영어 작은도서관,0,0,500000,500000
서울 동대문구,sk북카페 꿈땅,6800000,0,0,6800000
서울 송파구,가락2동새마을문고,1,1,1,3
서울 송파구,가락본동새마을문고,4860000,0,2000000,6860000
서울 구로구,가리봉동 마을문고,3200000,4320000,360000,7880000
서울 노원구,가온작은도서관,4200000,0,5220000,9420000
서울 노원구,가재울작은도서관,6200000,0,5220000,11420000
서울 은평구,갈현1동 문화의집 문고,1000000,0,0,1000000
서울 강동구,강동육아누리도서관,5600000,29040000,11700000,46340000
서울 강서구,강변월드작은도서관,0,0,0,0
서울 강북구,강북마을학교 밝빛작은도서관,999500,0,0,999500
서울 양천구,강서성결어린이도서관,0,0,1000000,1000000
서울 양천구,강서제일어린이문고,2000000,0,1000000,3000000
서울 강동구,강일9단지 누리도서관,0,0,0,0
서울 강동구,강일동 마을문고,4515000,0,800000,5315000
서울 강동구,강일리버파크6단지 책향기문고,2231590,0,568410,2800000
서울 구로구,개봉2동  새마을문고,3200000,4320000,360000,7880000
서울 구로구,개봉3동 마을문고,3200000,4320000,360000,7880000
서울 양천구,개울작은도서관,0,0,0,0
서울 강남구,개포1동 작은도서관,2264140,4880000,600000,7744140
서울 강남구,개포4동 작은도서관,1707480,2960000,272250,4939730
서울 송파구,거여1동새마을문고,2400000,0,2000000,4400000
서울 강동구,고덕리엔파크3단지 SH 작은도서관,2000000,0,1000000,3000000
서울 강동구,고덕마을도서관,0,0,1200000,1200000
서울 용산구,고래이야기,3450000,2400000,9000000,14850000
서울 양천구,고맙습니다 신정3동작은도서관,31000000,2000000,3000000,36000000
서울 관악구,고맙습니다 하난곡 작은도서관,12500000,31045000,19116000,62661000
서울 구로구,고척1동 마을문고,3200000,4280000,1500000,8980000
서울 구로구,고척2동 마을문고,3200000,4320000,360000,7880000
서울 구로구,고척교회도서관 책마을,3000000,0,2000000,5000000
서울 성북구,곰세마리 어린이 도서관,3680000,21150000,2770000,27600000
서울 마포구,공간민들레 청소년도서관,0,0,1000000,1000000
서울 마포구,공감작은도서관,3500000,0,15000000,18500000
서울 마포구,공덕동문고(마실길북카페),1200000,0,0,1200000
서울 관악구,관악산 시도서관,3000000,19808000,5399000,28207000
서울 광진구,광장동 새마을작은도서관,1792900,0,1200000,2992900
서울 광진구,광장현대파크빌도서관,0,0,600000,600000
서울 구로구,광진도서실,1000000,0,1500000,2500000
서울 구로구,구로1동 마을문고,3200000,4320000,360000,7880000
서울 구로구,구로2동 마을문고,3200000,4320000,360000,7880000
서울 구로구,구로4동 마을문고,3200000,4320000,360000,7880000
서울 구로구,구로5동 마을문고,3200000,4320000,360000,7880000
서울 관악구,구립신림청소년독서실,1200000,0,0,1200000
서울 동작구,구립약수작은도서관,13500000,56000000,20000000,89500000
서울 강서구,구암마을 작은도서관,1520000,0,5043955,6563955
서울 광진구,구의1동 새마을작은도서관,1782900,0,2880000,4662900
서울 광진구,구의2동 새마을작은도서관,3529930,0,3840000,7369930
서울 은평구,구파발10단지 제2작은도서관,800000,0,450000,1250000
서울 광진구,군자동 새마을작은도서관,1530000,0,1200000,2730000
서울 양천구,그루터기(신정이펜하우스2단지),2000000,0,2400000,4400000
서울 광진구,그루터기문고,2000000,0,3700000,5700000
서울 송파구,글길 작은도서관,2000000,0,0,2000000
서울 노원구,글꽃문고,0,3600000,203500,3803500
서울 용산구,글로벌아동도서관(서울목민아동),5000000,2520000,2400000,9920000
서울 강동구,글마루 작은도서관,6375000,0,3800000,10175000
서울 양천구,글바라기(신정이펜하우스1단지),3000000,0,5000000,8000000
서울 강서구,글벗누리 작은도서관(주민문고),1520000,0,5100000,6620000
서울 노원구,글빛작은도서관,2000000,0,1000000,3000000
서울 구로구,금강수목원아파트 작은 도서관,2300000,720000,0,3020000
서울 노원구,금빛도서관,3200000,7200000,600000,11000000
서울 성동구,금호1가동 북카페 책단지꿀단지,1708300,7619000,293600,9620900
서울 성동구,금호2.3가어린이작은도서관,1683600,7407000,0,9090600
서울 성동구,금호4가 어린이작은도서관,1368630,0,686650,2055280
서울 중랑구,기둥문고,2300000,0,0,2300000
서울 양천구,기쁨을나누는작은도서관,500000,0,0,500000
서울 성북구,기쁨이 자라는 작은도서관,3000000,0,24000000,27000000
서울 구로구,길:작은도서관,2000000,0,30000000,32000000
서울 성북구,길상도서관,2500000,0,500000,3000000
서울 구로구,길숲도서관,0,0,0,0
서울 성북구,길음 동부센트레빌 어린이글마당,600000,1000000,400000,2000000
서울 성북구,길음1동 새마을문고,3000000,0,0,3000000
서울 성북구,길음2동 새마을문고,1200000,0,800000,2000000
서울 성북구,길음뉴타운 푸르지오 도서관,4200000,0,6000000,10200000
서울 동작구,까망돌어린이도서관,0,0,0,0
서울 은평구,꿈 어린이도서관,2000000,8000000,4000000,14000000
서울 동대문구,꿈꾸는 도서관,500000,7247960,0,7747960
서울 중랑구,꿈꾸는 도서관,100000,100000,100000,300000
서울 양천구,꿈꾸는 도서관,1000000,20000000,3000000,24000000
서울 금천구,꿈꾸는 작은도서관,1935469,3752000,1972000,7659469
서울 송파구,꿈꾸는 작은도서관,1000000,1000000,4000000,6000000
서울 용산구,꿈꾸는 책마을,1800000,0,0,1800000
서울 종로구,꿈꾸는 평창동 작은도서관,2120000,11340000,1140000,14600000
서울 은평구,꿈꾸는i작은도서관,800000,1000000,1000000,2800000
서울 강북구,꿈꾸는문고,2200000,0,0,2200000
서울 노원구,꿈꾸는샘터작은도서관,2529000,532000,2000000,5061000
서울 구로구,꿈꾸는언덕 작은도서관(천왕 1단지),1277830,0,1229700,2507530
서울 노원구,꿈꾸는작은도서관,6200000,0,5220000,11420000
서울 구로구,꿈꾸는작은도서관,0,0,0,0
서울 강북구,꿈나무문고,0,0,4125000,4125000
서울 동대문구,꿈마루 도서관,13000000,0,7600000,20600000
서울 관악구,꿈마을도서관,5000000,13020000,16000000,34020000
서울 양천구,꿈사다리도서관,700000,0,2000000,2700000
서울 성동구,꿈샘 작은도서관,2000000,600000,1050000,3650000
서울 금천구,꿈씨 어린이 작은도서관,3174092,14400000,17263000,34837092
서울 마포구,꿈을 이루는 작은도서관,6200000,15600000,12946600,34746600
서울 도봉구,꿈을심는 작은도서관,0,0,400000,400000
서울 성북구,꿈의숲푸르지오 키즈&맘북카페,2188000,2040000,2860000,7088000
서울 영등포구,꿈이있는 도서관,1000000,5000000,2300000,8300000
서울 강서구,꿈이있는어린이도서관,6000000,0,0,6000000
서울 서대문구,꿈이있는작은도서관,2352000,0,3200000,5552000
서울 강서구,꿈자람책놀이터,2460000,8118710,2786520,13365230
서울 은평구,꿈지락작은도서관,3000000,0,5000000,8000000
서울 성동구,꿈터 어린이도서관,0,0,2000000,2000000
서울 성북구,꿈터 어린이도서관,1010000,10000000,8290000,19300000
서울 강서구,꿈터 작은도서관,1520000,0,5100000,6620000
서울 구로구,꿈터 작은도서관(천왕 6단지),2200000,0,3000000,5200000
서울 성북구,꿈틀도서관,2000000,12000000,6000000,20000000
서울 중랑구,꿈틀열매 작은도서관,500000,3600000,500000,4600000
서울 동대문구,나누리도서관,0,0,2400000,2400000
서울 금천구,나누리작은도서관,6000000,6000000,600000,12600000
서울 노원구,나눔작은도서관,4200000,0,5220000,9420000
서울 도봉구,나눔플러스 아름인도서관,0,0,0,0
서울 동대문구,나들목가족도서관,7516335,47284655,13612776,68413766
서울 용산구,나루 이촌북카페,29000000,3600000,90000000,122600000
서울 양천구,나무그늘(신정이펜하우스3단지),3000000,0,4000000,7000000
서울 종로구,나무와 열매 어린이 도서관,1800000,5200000,7000000,14000000
서울 관악구,낙성대공원 도서관,3000000,47487000,5956000,56443000
서울 관악구,낙성대동 우듬지 작은도서관,4264318,0,3400000,7664318
서울 관악구,난곡동 책사랑 작은도서관,4285710,0,3400000,7685710
서울 관악구,난곡주민도서관 새숲,7000000,15600000,28200000,50800000
서울 관악구,난향동 뜰안에 작은도서관,4195948,0,3400000,7595948
서울 광진구,날마다자라는나무,2000000,0,12000000,14000000
서울 서대문구,남가좌상성래미안아파트푸른북가페,1100000,6000000,900000,8000000
서울 용산구,남영동 새마을문고,1797680,1200000,0,2997680
서울 관악구,남현동 우리 작은도서관,4234450,0,3400000,7634450
서울 서초구,내곡동 작은도서관,6600000,0,0,6600000
서울 강서구,내발산작은도서관,1520000,0,5100000,6620000
서울 서초구,너나울 도서관,1000000,1600000,130000,2730000
서울 서초구,네이처힐3단지작은도서관(꿈찾는도서관),1000000,10800000,0,11800000
서울 서초구,네이처힐4단지작은도서관,10500000,11400000,950000,22850000
서울 서초구,네이처힐5단지작은도서관,1800000,15600000,2900000,20300000
서울 서초구,네이처힐6단지 작은도서관,50000,0,150000,200000
서울 서초구,네이처힐가든 작은도서관,45720,0,0,45720
서울 동작구,노량진1동마을문고,2000000,0,0,2000000
서울 동작구,노량진2동마을문고,2000000,0,0,2000000
서울 노원구,노원문화원작은도서관,6000000,0,4400000,10400000
서울 은평구,녹번동 문화사랑방,2000000,0,0,2000000
서울 마포구,늘푸른소나무 작은도서관,6200000,24212360,21648000,52060360
서울 서대문구,늘푸른열린작은도서관,2936240,0,3200000,6136240
서울 광진구,능동 새마을작은도서관,3539900,0,2400000,5939900
서울 금천구,다락방 작은도서관,1949266,3451000,1372800,6773066
서울 은평구,다문화도서관바오밥나무,2000000,1200000,3600000,6800000
서울 중구,다산동 새마을작은도서관,2968000,36612000,14040000,53620000
서울 관악구,다서원,2000000,2400000,0,4400000
서울 은평구,다섯콩도서관,6978000,17600000,12400000,36978000
서울 성북구,다슬도서관,2210000,13200000,8710000,24120000
서울 용산구,다시서기문고,1450000,0,0,1450000
서울 동대문구,다양한문화가모이는 어린이도서관 모두,2000000,38342960,31906510,72249470
서울 송파구,다우리 작은도서관,600000,0,2000000,2600000
서울 강남구,다움 영어 도서관,10000000,40000000,30000000,80000000
서울 용산구,단꿈작은도서관,2000000,0,0,2000000
서울 강북구,단비소리,3000000,0,10000000,13000000
서울 노원구,달내작은도서관,4200000,0,5220000,9420000
서울 양천구,달마을작은도서관(구 목2동 도서방),9000000,6000000,3000000,18000000
서울 동작구,담쟁이 작은도서관,0,0,0,0
서울 구로구,담쟁이넝쿨도서관,3500000,0,500000,4000000
서울 동대문구,답십리2동 민들레 작은도서관,0,0,520000,520000
서울 영등포구,당산1동 새마을공립작은도서관,2800000,9600000,2700000,15100000
서울 영등포구,당산2동 새마을공립작은도서관,3912530,9600000,2100000,15612530
서울 영등포구,당성책세상우리세상문고,3000000,0,10800000,13800000
서울 영등포구,대길열린문고,2000000,16800000,2500000,21300000
서울 영등포구,대림1동새마을공립작은도서관,2400000,9600000,1740000,13740000
서울 영등포구,대림2동 새마을공립작은도서관,2400000,9600000,1740000,13740000
서울 영등포구,대림3동 새마을공립작은도서관,2426410,9600000,1740000,13766410
서울 영등포구,대림동 작은 마을 문고,500000,0,0,500000
서울 동작구,대방동마을문고,800000,0,0,800000
서울 은평구,대조꿈나무어린이도서관,2000000,12376000,9746010,24122010
서울 은평구,대조제일교회꿈꾸는도서관,2200000,0,300000,2500000
서울 강남구,대치1 작은도서관,10912600,69562210,6531190,87006000
서울 관악구,대학동 녹두 작은도서관,4216672,0,3400000,7616672
서울 송파구,대한체육회 작은도서관,1200000,0,0,1200000
서울 중랑구,데시앙책울터,2000000,8400000,3600000,14000000
서울 강남구,도곡2동 작은 도서관,3605240,4520000,600000,8725240
서울 강동구,도담도담북카페,6375000,0,3800000,10175000
서울 종로구,도담도담한옥도서관,5000000,17050000,5929000,27979000
서울 금천구,도란도란 작은도서관,3008740,4200000,360000,7568740
서울 강서구,도란도란쉼터 작은도서관,3499000,0,8615360,12114360
서울 노원구,도란도란작은도서관,6200000,0,5220000,11420000
서울 강서구,도리샘 작은도서관,1520000,1134000,2996530,5650530
서울 영등포구,도림도서관,4078000,6786000,2136000,13000000
서울 영등포구,도림동새마을 공립작은도서관,2490740,9600000,2940000,15030740
서울 관악구,도림천에서 용나는 작은도서관,6000000,47415000,7770000,61185000
서울 도봉구,도봉1동 공립 작은도서관,4800000,6000000,1200000,12000000
서울 도봉구,도봉2동 공립 작은도서관,4800000,6000000,1200000,12000000
서울 도봉구,도봉구청행복작은도서관,8000000,12600000,0,20600000
서울 성북구,돈암2동 새마을문고,3124000,0,800000,3924000
서울 서대문구,돈의문센트레빌작은도서관,2000000,0,2400000,4400000
서울 영등포구,동네작은도서관,1500000,0,1200000,2700000
서울 동대문구,동대문구 문화회관 자료정보실,0,0,0,0
서울 성북구,동선동 새마을문고,2578640,0,1969000,4547640
서울 성북구,동선문고,2000000,0,0,2000000
서울 중랑구,"동성1,2차아파트문고",2000000,0,0,2000000
서울 중랑구,동성3차아파트문고,2000000,0,0,2000000
서울 동작구,동작샘터도서관,10743750,52875460,22794130,86413340
서울 중구,동화동 새마을작은도서관,2968000,11988000,2130000,17086000
서울 영등포구,두껍아두껍아 어린이도서관,500000,0,3000000,3500000
서울 영등포구,두날개작은도서관,2000000,0,0,2000000
서울 노원구,두레마을작은도서관,4200000,0,5220000,9420000
서울 관악구,두리하나 작은도서관,2000000,0,2000000,4000000
서울 종로구,두산아파트 새마을문고,550000,0,0,550000
서울 중랑구,두산화성문고,2000000,100000,0,2100000
서울 강동구,둔촌1동 마을문고,2375000,0,800000,3175000
서울 강동구,둔촌2동 마을문고,2350000,0,800000,3150000
서울 구로구,둘레길 작은도서관(천왕 4단지),1000000,0,2200000,3200000
서울 동대문구,둥그레문고,2000000,0,1600000,3600000
서울 강서구,등마루골 작은도서관,1520000,0,5100000,6620000
서울 강서구,등불작은도서관,5000000,10000000,3000000,18000000
서울 강서구,등촌아이파크 도서관,2500000,0,200000,2700000
서울 도봉구,라온제나 작은도서관,2450000,0,1400000,3850000
서울 강서구,람원도서관,5000000,5000000,1000000,11000000
서울 성북구,래미안 석관북카페,2000000,0,1600000,3600000
서울 동작구,래미안상도3차아파트문고,0,0,0,0
서울 중랑구,로뎀문고,200000,0,800000,1000000
서울 구로구,로즈빌도서관,1200000,0,0,1200000
서울 강동구,롯데캐슬도서관,4400000,20000000,2000000,26400000
서울 은평구,롯데캐슬문고,2086100,3000000,201200,5287300
서울 서초구,리본SH 작은도서관,0,0,220000,220000
서울 양천구,마을도서관(학마을2단지),0,0,0,0
서울 성동구,마장동 작은도서관,1998000,260000,0,2258000
서울 구로구,마중물 도서관,12000000,800000,8000000,20800000
서울 송파구,마천1동새마을문고,2400000,0,2000000,4400000
서울 중랑구,만나문고,300000,0,0,300000
서울 금천구,맑은누리 작은도서관,2123957,3458000,1922800,7504757
서울 은평구,매바위 북카페,2000000,0,0,2000000
서울 노원구,메아리작은도서관,4200000,0,5220000,9420000
서울 강동구,명일2동 마을문고,2375000,0,800000,3175000
서울 서대문구,명지어린이영어도서관,360000,1800000,0,2160000
서울 양천구,목1동 도서방,4089220,1000000,1000000,6089220
서울 양천구,목3동꿈자람작은도서관,10000000,1500000,3000000,14500000
서울 양천구,목4동 도서방,4211820,1000000,1000000,6211820
서울 성북구,목자도서관,2000000,0,1200000,3200000
서울 구로구,몽당연필도서관,0,0,1000000,1000000
서울 종로구,무악다솜방,2000000,12600000,0,14600000
서울 은평구,무지개영어도서관,500000,0,1000000,1500000
서울 성동구,무학도서관,3000000,3000000,0,6000000
서울 영등포구,문래동새마을공립작은도서관,4022360,9600000,4320000,17942360
서울 송파구,문정1동새마을문고,4600000,0,2000000,6600000
서울 송파구,문정작은도서관,2000000,0,6720000,8720000
서울 서대문구,문화촌어린이도서관,4886730,23231700,9596000,37714430
서울 은평구,물빛마을글방,1510500,33594000,3987500,39092000
서울 종로구,뭐든지 도서관,1200000,1200000,9600000,12000000
서울 금천구,미래꿈꾸는 작은도서관,500000,0,500000,1000000
서울 관악구,미성동 책의향기 작은도서관,4208915,0,3400000,7608915
서울 강북구,미아동 새마을문고,360000,2640000,0,3000000
서울 은평구,바다의별 작은도서관,7100000,0,5000000,12100000
서울 노원구,반디작은도서관,6200000,0,5220000,11420000
서울 영등포구,반딧불어린이도서관,2500000,1100000,1000000,4600000
서울 도봉구,반딧불이작은도서관,2200000,0,1200000,3400000
서울 강동구,반딧불작은도서관,4000000,0,3800000,7800000
서울 강동구,반석도서관,2000000,0,5000000,7000000
서울 서초구,반포1동 작은도서관,5117530,1200000,1200000,7517530
서울 서초구,반포2동 작은도서관,6600000,1200000,1200000,9000000
서울 서초구,반포3동 작은도서관,550000,0,1200000,1750000
서울 서초구,반포4동 작은도서관,3117358,1200000,1200000,5517358
서울 서초구,반포본동 작은도서관,550000,1200000,1200000,2950000
서울 강서구,발음도서관,2000000,520000,3500000,6020000
서울 강북구,밝은문고,500000,0,1000000,1500000
서울 강서구,방그리나작은도서관,1520000,0,5100000,6620000
서울 서초구,방배1동 작은도서관,4337600,1200000,1200000,6737600
서울 서초구,방배2동 작은도서관,4742260,1200000,1200000,7142260
서울 서초구,방배3동 작은도서관,5086389,1200000,1200000,7486389
서울 서초구,방배4동 작은도서관,6800000,1200000,1200000,9200000
서울 서초구,방배마을작은도서관,2000000,0,980000,2980000
서울 서초구,방배본동 작은도서관,2000000,0,0,2000000
서울 송파구,방이1동새마을문고,2400000,0,0,2400000
서울 송파구,방이2동새마을문고,2400000,0,2000000,4400000
서울 도봉구,방학1동 공립 작은도서관,4800000,6000000,1200000,12000000
서울 도봉구,방학2동 공립 작은도서관,4800000,6000000,1200000,12000000
서울 도봉구,방학3동 공립 작은도서관,4680000,1000000,0,5680000
서울 도봉구,방학청구아파트도서실,0,0,0,0
서울 구로구,배꼽빠지는 도서관,2000000,7200000,13200000,22400000
서울 강서구,배다리 작은도서관,3520000,0,5100000,8620000
서울 성북구,배바위골도서관,1950000,0,3000000,4950000
서울 은평구,백련산힐스 작은도서관,1000000,792000,307000,2099000
서울 용산구,백합어린이도서관,3431480,10800000,2017190,16248670
서울 강북구,번1동 새마을문고,2800000,0,1900000,4700000
서울 강북구,번3동 새마을문고,0,0,0,0
서울 강북구,벧엘도서관,0,0,0,0
서울 은평구,벧엘사랑문고,1000000,0,1000000,2000000
서울 성북구,별빛 작은도서관,1200000,0,1200000,2400000
서울 강북구,별빛초롱문고,2000000,30000000,6000000,38000000
서울 강서구,볏고을작은도서관,1520000,0,5100000,6620000
서울 동작구,보라매e편한세상작은도서관,3000000,2400000,319400,5719400
서울 관악구,보라매동 다사랑 작은도서관,4209972,0,3400000,7609972
서울 성북구,보문동 새마을문고,1200000,0,2250000,3450000
서울 마포구,복사골작은도서관,8033990,18126300,35627490,61787780
서울 은평구,복합문화공간[__틈],2000000,14400000,10800000,27200000
서울 동작구,본동작은도서관,7162500,42336450,21412460,70911410
서울 관악구,봉천5동작은문고,2000000,0,0,2000000
서울 관악구,봉현 작은 도서관,10334000,27107500,4822000,42263500
서울 영등포구,북마크 어린이도서관,6000000,0,12000000,18000000
서울 용산구,북카페 두드림,1800000,0,0,1800000
서울 용산구,북카페 라온아토,0,0,2826000,2826000
서울 용산구,북카페 자유다,3800000,0,0,3800000
서울 용산구,북카페 청마루,0,0,0,0
서울 마포구,북트립어린이영어도서관,35000000,52000000,24000000,111000000
서울 도봉구,북한산아이파크독서당,2500000,8700000,700000,11900000
서울 은평구,북한산힐스테이트1차아파트문고,900000,0,0,900000
서울 은평구,불광2동 자치회관문고(불광2동 주민센터),0,0,0,0
서울 종로구,불교영어도서관,0,0,30000000,30000000
서울 관악구,블루밍문고,3000000,6600000,6012000,15612000
서울 은평구,비전뜰 도서관,400000,0,1200000,1600000
서울 노원구,빛글북카페,4200000,0,5220000,9420000
서울 송파구,쁘레네 작은도서관 별찌,0,2000000,7200000,9200000
서울 성동구,사근동 어린이놀이터도서관,1724200,0,291000,2015200
서울 동작구,사당1동마을문고,800000,0,0,800000
서울 동작구,사당2동마을문고,788200,0,0,788200
서울 동작구,사당3동마을문고,0,0,0,0
서울 동작구,사당4동마을문고,800000,0,0,800000
서울 동작구,사당5동마을문고,450000,0,0,450000
서울 관악구,사랑기쁨도서관,1000000,2400000,2400000,5800000
서울 은평구,사랑방 작은도서관,6000000,0,3000000,9000000
서울 양천구,사랑방문고(신정이펜5단지),0,0,0,0
서울 금천구,산돌어린이도서관,3000000,0,2000000,5000000
서울 강북구,삼각산동 새마을문고,2400000,0,1836000,4236000
서울 성북구,삼선동 새마을문고,2520000,0,0,2520000
서울 성북구,삼선푸르지오 작은도서관,200000,0,700000,900000
서울 강남구,삼성도서관,11583720,79307470,9380310,100271500
서울 관악구,삼성동 샛별 작은도서관,4283082,0,3400000,7683082
서울 관악구,삼성작은도서관,10333000,26070000,4810000,41213000
서울 강북구,삼양동 새마을문고,1300000,0,1000000,2300000
서울 송파구,삼전동새마을문고,2400000,0,2000000,4400000
서울 노원구,삼창도서관,1918000,0,49000,1967000
서울 종로구,삼청공원 숲속도서관,5000000,0,73371000,78371000
서울 종로구,삼청동 새마을문고,1000000,0,500000,1500000
서울 노원구,상계숲속작은도서관,80000000,0,700000,80700000
서울 노원구,상계주공14단지아파트 문화사랑방도서실,1500000,0,0,1500000
서울 동작구,상도1동마을문고,2504900,0,600000,3104900
서울 동작구,상도2동마을문고,0,0,0,0
서울 동작구,상도3동마을문고,0,0,0,0
서울 동작구,상도4동마을문고,2000000,0,0,2000000
서울 동작구,상도SH-Ville작은도서관,0,0,0,0
서울 동작구,상도더샵아파트 작은도서관,2000000,4800000,0,6800000
서울 동작구,상도중앙 작은도서관,0,0,0,0
서울 은평구,상림글방,2600000,0,720000,3320000
서울 은평구,상림마을작은도서관,5000000,50790000,72337000,128127000
서울 마포구,상암동문고,1200000,0,0,1200000
서울 마포구,상암월드컵파크11단지도서관,1755870,2132000,2574175,6462045
서울 마포구,상암월드컵파크7단지도서관,2000000,0,1000000,3000000
서울 강동구,상일동 마을문고,2375000,0,800000,3175000
서울 구로구,새광명도서관,2000000,0,0,2000000
서울 중랑구,새로운어린이도서관,220000,0,0,220000
서울 중랑구,새마을문고망우3동분회 작은도서관,2000000,0,1080000,3080000
서울 중랑구,새마을문고망우본동분회 작은도서관,2000000,0,1080000,3080000
서울 중랑구,새마을문고면목2동분회 작은도서관,2000000,0,1080000,3080000
서울 중랑구,새마을문고면목3.8동분회 작은도서관,2000000,0,1080000,3080000
서울 중랑구,새마을문고면목4동분회 작은도서관,2000000,0,1080000,3080000
서울 중랑구,새마을문고면목5동분회 작은도서관,2000000,0,1080000,3080000
서울 중랑구,새마을문고면목7동분회 작은도서관,2000000,0,1080000,3080000
서울 중랑구,새마을문고묵1동분회 작은도서관,2000000,0,1080000,3080000
서울 중랑구,새마을문고묵2동분회 작은도서관,2000000,0,1080000,3080000
서울 중랑구,새마을문고상봉1동분회 작은도서관,2000000,0,1080000,3080000
서울 중랑구,새마을문고상봉2동분회 작은도서관,2000000,0,1080000,3080000
서울 중랑구,새마을문고신내1동분회 작은도서관,2000000,0,1080000,3080000
서울 중랑구,새마을문고중화1동분회 작은도서관,2000000,0,1080000,3080000
서울 중랑구,새마을문고중화2동분회 작은도서관,2000000,0,1080000,3080000
서울 도봉구,새마을어린이문고,0,0,340000,340000
서울 광진구,새빛작은도서관,4461400,350000,2540600,7352000
서울 서대문구,새솔도서실,2000000,0,122800,2122800
서울 서대문구,새싹작은도서관,4851770,23231700,10230000,38313470
서울 금천구,새재미작은도서관,1000000,0,1000000,2000000
서울 양천구,새희망작은도서관,3000000,4500000,2000000,9500000
서울 강서구,생각열매 작은도서관,3000000,0,5700000,8700000
서울 송파구,생각쟁이 작은도서관,5000000,0,12000000,17000000
서울 도봉구,생글작은도서관,2000000,10000000,10500000,22500000
서울 동작구,생명나무도서관,2000000,0,600000,2600000
서울 성북구,생명의전화종합사회복지관 가족도서관,1093490,3762500,4884270,9740260
서울 성북구,서경로꿈마루도서관,2999090,58356170,26484664,87839924
서울 마포구,서교동문고,2599800,0,1057000,3656800
서울 구로구,서남작은 도서관,0,0,0,0
서울 관악구,서림동 글사랑 작은도서관,4232950,0,3400000,7632950
서울 은평구,서문어린이도서관,700000,0,0,700000
서울 강북구,서영문고,2000000,0,1500000,3500000
서울 구로구,서울가든빌라 도서관,2000000,0,500000,2500000
서울 구로구,서울남문고,2800000,0,200000,3000000
서울 용산구,서울비젼문고,1450000,0,3000000,4450000
서울 성북구,서울소망작은도서관,1750000,0,600000,2350000
서울 성동구,서울제일비젼도서관,2000000,0,2000000,4000000
서울 관악구,서원동 어울 작은도서관,4215450,0,3400000,7615450
서울 강동구,서원마을작은도서관,2000000,0,3240000,5240000
서울 서초구,서초1동 작은도서관,5219730,1200000,1200000,7619730
서울 서초구,서초2동 작은도서관,5500000,0,0,5500000
서울 서초구,서초3동 작은도서관,7086389,1200000,1200000,9486389
서울 서초구,서초4동 작은도서관,5680917,0,1312140,6993057
서울 서초구,서초어린이책마을,1900000,0,1000000,2900000
서울 성북구,석관동 새마을문고,2275000,0,0,2275000
서울 종로구,석천문화관,10000000,10000000,5000000,25000000
서울 성북구,성광작은도서관,240000,0,1200000,1440000
서울 강동구,성내1동 마을문고,2375000,0,800000,3175000
서울 강동구,성내2동 마을문고,2375000,0,800000,3175000
서울 강동구,성내3동 마을문고,4375000,0,800000,5175000
서울 동작구,성대골어린이도서관,2000000,0,16800000,18800000
서울 강동구,성대문고,200000,0,1200000,1400000
서울 성동구,성락도서관,2000000,0,500000,2500000
서울 마포구,성메 작은도서관,6200000,19400000,19448000,45048000
서울 성북구,성북동 새마을문고,1200000,0,2100000,3300000
서울 마포구,성산1동문고,1200000,0,0,1200000
서울 마포구,성산글마루작은도서관,6200000,20600000,8736000,35536000
서울 성동구,성수1가2동 작은도서관,1764700,5644000,0,7408700
서울 성동구,성수1가제1동 작은도서관,1451700,5644000,0,7095700
서울 성동구,성수2가제1동 작은도서관,1685000,0,0,1685000
서울 성동구,성수2가제3동 작은도서관,3391300,8092000,400000,11883300
서울 강북구,성심중앙문고,3000000,3600000,3500000,10100000
서울 중랑구,성원아파트문고,200000,0,400000,600000
서울 관악구,성현동 파랑새 작은도서관,4296429,0,3400000,7696429
서울 송파구,세계동화 작은도서관,3000000,8000000,9600000,20600000
서울 강남구,세곡도서관,11423380,53738160,15745780,80907320
서울 관악구,세광영어도서관,500000,0,500000,1000000
서울 성북구,세레니티문고,0,0,360000,360000
서울 성북구,소곤소곤 왁자지껄,0,0,0,0
서울 송파구,소나무언덕1호 작은도서관,10105000,49595000,20927000,80627000
서울 송파구,소나무언덕2호작은도서관,2416000,52733103,49969897,105119000
서울 송파구,소나무언덕4호 작은도서관,12864000,66674100,27021900,106560000
서울 송파구,소나무언덕잠실본동 작은도서관,22633000,61049805,60404184,144086989
서울 중구,손기정문화체육센터정보도서관,9999490,30000000,4240250,44239740
서울 마포구,솔로몬도서관,2300000,0,3700000,6000000
서울 도봉구,솔밭작은도서관,2000000,0,100000,2100000
서울 은평구,솔빛도서관,0,0,500000,500000
서울 강서구,송정 작은도서관(공항동),1520000,0,5100000,6620000
서울 강북구,송중동 새마을문고,2000000,0,400000,2400000
서울 강북구,송천 북카페,0,0,0,0
서울 강북구,송천 아름인 도서관,1000000,0,1000000,2000000
서울 강북구,송천동 새마을문고,0,2400000,1000000,3400000
서울 송파구,송파1동새마을문고,2400000,0,2000000,4400000
서울 송파구,송파2동새마을문고,2400000,0,0,2400000
서울 송파구,송파어린이영어 작은도서관,21753980,116822298,77391580,215967858
서울 송파구,송파파크데일1단지도서관,2000000,0,2400000,4400000
서울 구로구,수궁동 마을문고,3200000,4320000,360000,7880000
서울 동작구,수도지역도서관,0,0,0,0
서울 노원구,수락작은도서관,4200000,0,5220000,9420000
서울 강서구,수명산작은도서관,4385110,1469270,4170000,10024380
서울 은평구,수색장로교회도서관,3000000,0,1000000,4000000
서울 강남구,수서동 작은도서관,1044100,980000,236190,2260290
서울 서초구,수송작은도서관,1200000,2265000,2202000,5667000
서울 강북구,수유2동 새마을문고,4500000,0,500000,5000000
서울 강북구,수유3동 새마을문고,2000000,0,1500000,3500000
서울 강북구,수유마을작은도서관,3000000,1000000,3000000,7000000
서울 종로구,숭인마루 작은도서관,2000000,12600000,0,14600000
서울 관악구,숲속 작은도서관,0,7200000,1800000,9000000
서울 구로구,숲속꿈나무어린이도서관,2000000,0,0,2000000
서울 은평구,숲속향기 작은도서관,3000000,0,17690705,20690705
서울 송파구,스토리빈 작은도서관,2000000,0,0,2000000
서울 은평구,시니어전문도서관,1700000,0,300000,2000000
서울 은평구,시루뫼쉼터,300000,2723000,0,3023000
서울 영등포구,신길1동새마을공립작은도서관,2561190,9600000,1740000,13901190
서울 영등포구,신길2동 새마을공립작은도서관,2459270,8843730,1419045,12722045
서울 영등포구,신길3동 새마을공립작은도서관,2148430,9600000,1740000,13488430
서울 영등포구,신길4동 새마공립작은도서관,4016720,9600000,1540000,15156720
서울 영등포구,신길5동새마을공립작은도서관,4122570,9600000,1636750,15359320
서울 영등포구,신길6동 새마을공립작은도서관,3778020,11000000,1740000,16518020
서울 영등포구,신길7동 새마을 공립작은도서관,2400000,0,1740000,4140000
서울 중랑구,신내 지혜담은 도서관,5000000,18000000,18000000,41000000
서울 중랑구,신내우디안2단지 나무그늘도서관,0,0,0,0
서울 중구,신당5동 새마을작은도서관,4968000,11988000,3920000,20876000
서울 중구,신당동 새마을작은도서관,2968000,11988000,1800000,16756000
서울 동작구,신대방1동마을문고,2000000,0,0,2000000
서울 동작구,신대방2동마을문고,0,0,0,0
서울 구로구,신도림 4차마을문고,1800000,0,600000,2400000
서울 구로구,신도림 월드메르디앙 어린이 작은도서관,0,0,0,0
서울 구로구,신도림동 마을문고,3200000,4320000,360000,7880000
서울 구로구,신도림어린이영어작은도서관,16503000,18000000,6000000,40503000
서울 구로구,신도림현대도서관,0,0,0,0
서울 관악구,신림동 굴렁쇠 작은도서관,4217663,0,3200000,7417663
서울 관악구,신림푸르지오 도서관,2000000,0,1800000,3800000
서울 중랑구,신방주문고,1000000,0,0,1000000
서울 은평구,신사1동 도서사랑방,0,0,0,0
서울 은평구,신사2동 도서사랑방,0,0,0,0
서울 강남구,신사동 작은도서관,1667310,4590000,553200,6810510
서울 관악구,신사동 해오름 작은도서관,4373582,0,3400000,7773582
서울 은평구,신사어린이도서관,3000000,26219580,4900000,34119580
서울 동작구,신상도문고,2420000,0,0,2420000
서울 마포구,신수동문고,1200000,0,0,1200000
서울 관악구,신원동 울타리 작은도서관,4285525,0,3400000,7685525
서울 양천구,신월1동 도서방,3143380,0,1000000,4143380
서울 양천구,신월2동 도서방,3426670,1000000,1000000,5426670
서울 양천구,신월3동 도서방,3707530,1000000,1000000,5707530
서울 양천구,신월6동 도서방,3912570,1000000,1000000,5912570
서울 양천구,신월7동 도서방,3383530,1000000,1000000,5383530
서울 양천구,신월아파트부녀회도서방,0,0,0,0
서울 중랑구,신일문고,500000,0,3000000,3500000
서울 양천구,신정1동 도서방,3904530,1000000,1000000,5904530
서울 양천구,신정2동 도서방,3801000,1000000,1000000,5801000
서울 양천구,신정3동 도서방(현장민원실),4049930,1000000,1000000,6049930
서울 양천구,신정6동 도서방,4050330,1000000,1000000,6050330
서울 양천구,신정7동 도서방,3870190,1000000,1000000,5870190
서울 도봉구,쌍문1동 공립 작은도서관,4900000,6000000,1450000,12350000
서울 도봉구,쌍문2동 공립 작은도서관,4800000,6000000,1200000,12000000
서울 도봉구,쌍문3동 공립 작은도서관,4800000,6000000,1400000,12200000
서울 도봉구,쌍문4동 공립 작은도서관,4800000,6000000,1200000,12000000
서울 송파구,쌍용 북카페,2000000,0,1500000,3500000
서울 도봉구,씨앗문고,2000000,0,800000,2800000
서울 성북구,아가세 작은도서관,1000000,0,7000000,8000000
서울 서대문구,아낌없이주는나무,900000,3600000,1900000,6400000
서울 송파구,아름다운 꿈 작은도서관,3000000,0,0,3000000
서울 송파구,아름다운 작은도서관,1000000,0,0,1000000
서울 도봉구,아름다운도서관,1300000,0,2000000,3300000
서울 양천구,아름다운도서관,0,0,1800000,1800000
서울 구로구,아름도서관,2800000,0,2000000,4800000
서울 성북구,아름드리 작은도서관,3600000,0,6000000,9600000
서울 마포구,아름드리 작은도서관,6000000,16800000,22745000,45545000
서울 광진구,아름드리작은도서관,1724370,0,1368500,3092870
서울 동대문구,아름숲어린이문고,2000000,0,1800000,3800000
서울 강서구,아리향기 작은도서관,1520000,0,5100000,6620000
서울 은평구,아오스딩도서관,500000,0,1200000,1700000
서울 서대문구,아이누리작은도서관,4851770,25988100,2800000,33639870
서울 마포구,아이도북센터,1000000,0,1000000,2000000
서울 광진구,아차산아래 작은도서관 놀자,8000000,12000000,76000000,96000000
서울 성북구,안암동 새마을문고,3544000,0,0,3544000
서울 서대문구,알음알음작은도서관,5097220,23231700,10096000,38424920
서울 강동구,암사1동 마을문고,4375000,0,800000,5175000
서울 강동구,암사3동 마을문고,3900000,0,1385000,5285000
서울 강동구,암사종합시장문고,4000000,9000000,3240000,16240000
서울 강남구,압구정동 작은도서관,1661440,4940000,600000,7201440
서울 중구,약수동 새마을작은도서관,2968000,11988000,1800000,16756000
서울 서초구,양재1동 작은도서관,5284720,1200000,1200000,7684720
서울 서초구,양재2동 작은도서관,6000000,120000,120000,6240000
서울 양천구,양천연세주민문고,5000000,7200000,1000000,13200000
서울 영등포구,양평1동 새마을공립작은도서관,2448810,9600000,1680000,13728810
서울 영등포구,양평2동 새마을공립작은도서관,4011210,9600000,1740000,15351210
서울 광진구,어린이 작은도서관 주영심 나무,0,14400000,3900000,18300000
서울 종로구,어린이도서관 꿈과쉼,3253820,0,8615760,11869580
서울 동대문구,어린이도서관 꿈틀,5500000,13200000,15000000,33700000
서울 중구,어린이도서관 느티나무,3400000,19750000,28230000,51380000
서울 은평구,어린이도서관 동네북,5000000,12000000,6000000,23000000
서울 성동구,어린이도서관 책읽는엄마 책읽는 아이,5420230,24000000,60861380,90281610
서울 서대문구,어린이도서관꿈꾸는세상,1437035,6708200,987500,9132735
서울 용산구,어린이아뜰리에,0,16800000,0,16800000
서울 영등포구,언니네작은도서관,1200000,9600000,12000000,22800000
서울 구로구,에델도서관,0,0,0,0
서울 마포구,에듀까페 맘,2300000,4800000,3200000,10300000
서울 영등포구,여의동 새마을공립작은도서관,2465090,9600000,1740000,13805090
서울 은평구,역마루작은도서관,5000000,0,3600000,8600000
서울 강서구,역마을 작은도서관,1520000,3213000,1887000,6620000
서울 강남구,역삼2 작은도서관,0,3010000,412900,3422900
서울 마포구,연남동문고,1200000,0,0,1200000
서울 용산구,연어린이도서관,1450000,0,0,1450000
서울 구로구,연지타운1단지작은도서관,5000000,5000000,5000000,15000000
서울 강남구,열린도서관,11196590,51878240,10570930,73645760
서울 노원구,열린작은도서관,4200000,0,5220000,9420000
서울 마포구,염리동문고,1200000,0,0,1200000
서울 마포구,염산문고,1800000,0,200000,2000000
서울 은평구,영광영재도서관,500000,0,1200000,1700000
서울 영등포구,영등포동 새마을공립 작은도서관,2591100,10800000,2940000,16331100
서울 영등포구,영등포본동 새마을공립작은도서관,2057980,6080180,1419045,9557205
서울 영등포구,영등포새마을구지부공립작은도서관,2308070,9600000,2160000,14068070
서울 중랑구,예광독서방,1200000,4200000,2800000,8200000
서울 송파구,예꿈틀어린이도서관,2000000,6000000,1900000,9900000
서울 종로구,예능도서관,4000000,0,1170000,5170000
서울 광진구,예드림문고,2819940,4300000,29164000,36283940
서울 은평구,예뜰도서관,5480000,0,5000000,10480000
서울 강서구,예뜰문고,2000000,12000000,2400000,16400000
서울 성동구,예람작은도서관,2500000,6000000,1000000,9500000
서울 서초구,예손그루터기,2500000,0,1000000,3500000
서울 송파구,예인작은도서관,3000000,0,9000000,12000000
서울 구로구,예향 작은도서관,0,0,0,0
서울 송파구,오금동새마을문고,2360000,0,2000000,4360000
서울 구로구,오류1동 마을문고,3200000,4320000,360000,7880000
서울 구로구,오류2동 마을문고,3200000,4320000,360000,7880000
서울 구로구,오류문고,100000,0,1000000,1100000
서울 송파구,오륜동새마을문고,2400000,0,2000000,4400000
서울 강북구,오패산마을공동체마을꿈터도서관,1650000,8500000,8000000,18150000
서울 은평구,올리브나무 도서관,900000,0,8600000,9500000
서울 강동구,옹기종기작은도서관,2000000,6600000,42780000,51380000
서울 강서구,옹기종기작은도서관,1000000,3528000,1800000,6328000
서울 도봉구,옹달샘 작은도서관,0,0,0,0
서울 강서구,옹달샘 작은도서관,1520000,0,5100000,6620000
서울 마포구,옹달샘어린이도서관,2000000,0,1500000,3500000
서울 마포구,와글와글 작은도서관,2000000,0,14400000,16400000
서울 성동구,왕십리도서관,2000000,0,1000000,3000000
서울 성동구,왕십리도선동 희망문고,1050000,200000,750000,2000000
서울 성동구,왕십리제2동 작은도서관,1407900,0,440000,1847900
서울 영등포구,요셉의원작은도서관,6000000,0,0,6000000
서울 관악구,용꿈꾸는 작은도서관,6987000,49765000,24869000,81621000
서울 성동구,용답동 어린이작은도서관 ,1533300,5649000,291200,7473500
서울 용산구,용산2가동 새마을문고,1800000,0,0,1800000
서울 용산구,용산e편한세상 북카페,3310000,9000000,0,12310000
서울 동대문구,용신동 열린문고,700000,0,0,700000
서울 강북구,우리동네작은도서관,0,6000000,300000,6300000
서울 성북구,우리들문고,2000000,0,1200000,3200000
서울 강서구,우리작은도서관,1000000,0,1000000,2000000
서울 서초구,우면SH작은도서관,1250000,0,600000,1850000
서울 은평구,우물골 8단지 작은 도서관,2000000,0,124000,2124000
서울 은평구,우물골 마슬 문고,600000,2400000,600000,3600000
서울 은평구,우물골제4작은도서관(큰꿈작은도서관),2320000,0,270000,2590000
서울 강북구,우이동 새마을문고,2000000,2400000,0,4400000
서울 강서구,우장산동작은도서관,0,0,0,0
서울 서대문구,원천어린이도서관,3000000,0,500000,3500000
서울 성북구,월곡1동 새마을문고,2536200,0,1356000,3892200
서울 송파구,위례24단지 작은도서관,5000000,12000000,1200000,18200000
서울 서초구,육아정책연구소 자료실,26000000,24000000,50000000,100000000
서울 서초구,윤봉길새책도서관,10000000,18000000,5000000,33000000
서울 은평구,은광교회도서관,3000000,12000000,5000000,20000000
서울 구로구,은성도서관,800000,400000,300000,1500000
서울 관악구,은천2단지작은도서관,2000000,0,100000,2100000
서울 관악구,은천동 한울작은도서관,4221995,0,3400000,7621995
서울 은평구,은평뉴타운 구파발 9단지 도서관,3000000,0,900000,3900000
서울 은평구,은평뉴타운 구파발9단지 제1관리소도서관,0,250000,0,250000
서울 은평구,은평뉴타운 마고정2단지 문고,1000000,0,3000000,4000000
서울 은평구,은평뉴타운 상림마을 제7단지문고,2000000,0,1200000,3200000
서울 은평구,은평뉴타운 상림마을14단지마을문고,3000000,0,350000,3350000
서울 은평구,은평뉴타운5단지문고,100000,0,300000,400000
서울 은평구,은평어린이영어도서관,0,10000000,13313000,23313000
서울 금천구,은행나무어린이도서관,2000000,4800000,20000000,26800000
서울 양천구,은행정마을북카페,500000,0,5000000,5500000
서울 중랑구,은혜의숲 작은도서관,500000,1000000,6000000,7500000
서울 성동구,응봉동 어린이 작은도서관,1674400,7582000,226000,9482400
서울 은평구,응암1동 은평문화의집 작은도서관,0,0,0,0
서울 은평구,응암3동 도서사랑방,0,0,0,0
서울 은평구,응암도서관,2500000,0,2000000,4500000
서울 구로구,이니텍도서관,2500000,0,700000,3200000
서울 양천구,이레문고,2000000,40000000,5000000,47000000
서울 동대문구,이문1동 꿈꾸는 작은도서관,0,0,225000,225000
서울 동대문구,이문어린이도서관(숲속작은도서관),57427248,9868116,45633541,112928905
서울 동대문구,이문체육문화센터 어린이도서관,4680000,30000000,1200000,35880000
서울 송파구,이사랑나눔도서관,3600000,15000000,12000000,30600000
서울 용산구,이태원2동새마을문고,1800000,0,0,1800000
서울 종로구,이화마을 작은도서관,2000000,12600000,0,14600000
서울 은평구,인덕문고,1241000,0,759000,2000000
서울 관악구,인헌동 보물섬 작은도서관,4261225,0,3400000,7661225
서울 강남구,일원본동 작은도서관,1671120,4940000,600000,7211120
서울 광진구,자양1동 새마을작은도서관,1530000,0,8000000,9530000
서울 광진구,자양2동 새마을작은도서관,1530000,0,3200000,4730000
서울 광진구,자양3동 새마을작은도서관,1530000,0,4200000,5730000
서울 광진구,자양4동 새마을작은도서관,1530000,0,4960000,6490000
서울 노원구,작고행복한청구3차도서관,2000000,1200000,500000,3700000
서울 종로구,작은도서관 삼봉서랑,5000000,36000000,8434000,49434000
서울 동대문구,작은도서관 책놀이터,0,8000000,43000000,51000000
서울 강북구,작은도서관 책이랑놀자,1200000,21378600,7453110,30031710
서울 도봉구,작은도서관 책읽는사람들,3000000,0,12000000,15000000
서울 강북구,작은도서관 함께놀자,2000000,0,5500000,7500000
서울 강서구,작은샘작은도서관,3000000,1000000,1500000,5500000
서울 송파구,잠실3동새마을문고,2400000,0,2000000,4400000
서울 송파구,잠실4동새마을문고,2400000,0,2000000,4400000
서울 송파구,잠실6동새마을문고,2400000,0,0,2400000
서울 송파구,잠실7동새마을문고,2400000,0,2000000,4400000
서울 서초구,잠원동 작은도서관,6600000,1200000,1200000,9000000
서울 동대문구,장안1동 작은도서관,3000000,0,0,3000000
서울 동대문구,장안2동 작은도서관,690000,0,2260000,2950000
서울 성북구,장암교회 쉴만한 물가 작은도서관,2000000,0,790000,2790000
서울 성북구,장월SH빌 작은도서관,0,0,2400000,2400000
서울 성북구,장위1동새마을문고,3010000,0,799400,3809400
서울 성북구,장위2동 새마을문고,3001900,0,800000,3801900
서울 송파구,장지동새마을문고,2400000,0,2000000,4400000
서울 동대문구,전농2동 작은도서관,2995000,0,780000,3775000
서울 중구,정동어린이도서관 '하늘씨앗',2641090,9600000,2000000,14241090
서울 성북구,정릉1동새마을문고,3224000,0,814000,4038000
서울 성북구,정릉4동 새마을문고,1700000,0,1200000,2900000
서울 성북구,정릉푸르지오 북카페,1600000,0,2800000,4400000
서울 강동구,정원작은도서관,1146000,16800000,1200000,19146000
서울 은평구,정임도서관,1000000,0,0,1000000
서울 성북구,종암2차SK뷰(아) 작으도서관,0,0,4590000,4590000
서울 성북구,종암동 새마을문고,3000000,0,0,3000000
서울 양천구,종이비행기작은도서관,2000000,0,3150000,5150000
서울 송파구,좋은물결도서관,3239265,0,0,3239265
서울 강서구,좋은친구어린이도서관,3300000,0,2000000,5300000
서울 송파구,주님의 교회 문고,1900000,2400000,0,4300000
서울 동작구,주님의 숲,2000000,0,0,2000000
서울 강서구,주신작은도서관,2000000,2400000,2000000,6400000
서울 강북구,주영광 어린이도서관,1000000,0,500000,1500000
서울 강서구,주함아동문고,0,0,0,0
서울 노원구,중계사랑북카페,4200000,0,5220000,9420000
서울 노원구,중계주공10단지책과친구들,1947500,0,52500,2000000
서울 광진구,중곡1동 새마을작은도서관,1830000,0,1900000,3730000
서울 광진구,중곡2동 새마을작은도서관,1530000,0,6740000,8270000
서울 광진구,중곡3동 새마을작은도서관,2530000,0,6730000,9260000
서울 광진구,중곡4동 새마을작은도서관,1530000,0,3200000,4730000
서울 광진구,중곡교회작은도서관,2530000,0,4719000,7249000
서울 중구,중구청 작은도서관,10000000,18000000,0,28000000
서울 중랑구,중랑소방서문고,1000000,0,0,1000000
서울 관악구,중앙동 새싹 작은도서관,5047804,0,3000000,8047804
서울 구로구,중앙하이츠도서관,1200000,0,5500000,6700000
서울 송파구,즐거운가 작은도서관,1100000,0,900000,2000000
서울 은평구,증산동성산주민문고,900000,0,2000000,2900000
서울 양천구,지양마을작은도서관,5600000,14000000,5000000,24600000
서울 은평구,지혜누리작은도서관,0,0,0,0
서울 종로구,지혜만들기 작은도서관,2000000,12600000,0,14600000
서울 동작구,지혜문고,0,0,0,0
서울 은평구,지혜숲 작은도서관,1250000,0,350000,1600000
서울 금천구,지혜의숲,2000000,0,7000000,9000000
서울 금천구,지혜의숲 작은도서관,1000000,0,9000000,10000000
서울 은평구,징검다리도서관,2500000,12000000,3000000,17500000
서울 영등포구,쪼물왕국어린이도서관,2000000,0,2000000,4000000
서울 금천구,참새 작은도서관 ,2946823,22151350,4971322,30069495
서울 구로구,참새소풍 작은도서관(천왕 2단지),2500000,0,2200000,4700000
서울 송파구,참좋은 작은도서관,2000000,10000000,10000000,22000000
서울 도봉구,창1동 공립 작은도서관,4800000,6000000,1200000,12000000
서울 도봉구,창2동 공립 작은도서관,4800000,6000000,1200000,12000000
서울 도봉구,창3동 공립 작은도서관,4800000,6000000,1200000,12000000
서울 도봉구,창4동 공립 작은도서관,4800000,6000000,1200000,12000000
서울 도봉구,창5동 공립 작은도서관,4800000,6000000,1200000,12000000
서울 종로구,창신1동하람 작은도서관,2000000,12600000,0,14600000
서울 종로구,창이 작은도서관,1000000,12600000,1000000,14600000
서울 강서구,채움 작은도서관,1520000,0,5480000,7000000
서울 양천구,채움도서관,3000000,0,15000000,18000000
서울 성북구,책놀이터작은도서관,2000000,3600000,6000000,11600000
서울 노원구,책누리작은도서관,6200000,0,5220000,11420000
서울 은평구,책뜰에도서관,2500000,5000000,1600000,9100000
서울 강서구,책마루 작은도서관,1520000,0,5520000,7040000
서울 노원구,책사랑북카페,4200000,0,5220000,9420000
서울 관악구,책쉼터,3000000,0,360000,3360000
서울 금천구,책이든거리 작은도서관,2880000,1170000,3660000,7710000
서울 강북구,책이랑 놀자,2000000,12000000,3000000,17000000
서울 관악구,책이랑놀이랑도서관,12500000,12251000,9676000,34427000
서울 노원구,책이랑친구랑작은도서관,4200000,0,5220000,9420000
서울 송파구,책읽는 나무 의자,2000000,0,1000000,3000000
서울 강북구,책읽는 마을,3000000,3000000,10000000,16000000
서울 금천구,책읽는마을,1360500,0,0,1360500
서울 양천구,책읽는쉼터,1000000,0,500000,1500000
서울 금천구,책읽는주민사랑방 작은도서관,1818160,966000,5782720,8566880
서울 강서구,책향기작은도서관,1520000,0,5100000,6620000
서울 서대문구,천연동하늘샘작은도서관,2310980,0,3200000,5510980
서울 서대문구,천연뜨란채문고,2000000,0,4800000,6800000
서울 구로구,천왕이펜하우스3단지 작은도서관,750000,0,2950000,3700000
서울 강동구,천일어린이도서관,3000000,47334409,21465591,71800000
서울 강동구,천호1동 마을문고,2375000,0,800000,3175000
서울 강동구,천호3동 마을문고,2375000,0,800000,3175000
서울 금천구,청개구리 작은도서관,3000000,15570000,630000,19200000
서울 중구,청구동 새마을작은도서관,4968000,11988000,12286000,29242000
서울 관악구,청룡동 숯고을 작은도서관,4217380,0,3400000,7617380
서울 관악구,청룡작은도서관,10333000,25883000,4880000,41096000
서울 관악구,청림동 푸른숲 작은도서관,4209015,0,3200000,7409015
서울 은평구,청소년도서관작공,1040400,0,959600,2000000
서울 용산구,청소년수련관 푸르미르,4392740,0,0,4392740
서울 종로구,청운효자동 북카페,2000000,12600000,0,14600000
서울 종로구,청파도서관,7000000,0,10500000,17500000
서울 강동구,초대구름도서관,1000000,0,1620000,2620000
서울 강남구,초록공간작은도서관,500000,0,1000000,1500000
서울 은평구,초록길도서관,7500000,2500000,20000000,30000000
서울 도봉구,초록나라작은도서관,3000000,0,7200000,10200000
서울 마포구,초록리본도서관,8365712,17250000,30868037,56483749
서울 강서구,초록향기 작은도서관,2000000,0,6000000,8000000
서울 노원구,초안산숲속작은도서관,74204180,0,16800000,91004180
서울 광진구,카로스도서관,1548700,0,410700,1959400
서울 중랑구,카르포스 도서관,1200000,0,10800000,12000000
서울 은평구,캐슬문고,2900000,0,5000000,7900000
서울 구로구,코딱지 도서관,0,0,0,0
서울 동대문구,콩나무 어린이도서관,4000000,7000000,3000000,14000000
서울 구로구,큐브북카페,1800000,0,0,1800000
서울 성북구,큰꿈 도서관,0,0,0,0
서울 강서구,큰마음 작은도서관,1520000,0,5100000,6620000
서울 종로구,통인 어린이 작은도서관,7000000,157566013,4634474,169200487
서울 강북구,트리베라 1차 문고,0,0,3600000,3600000
서울 구로구,파크푸르지오 도서관,0,0,0,0
서울 광진구,평강마을도서관,4495600,0,8009400,12505000
서울 양천구,평생학습센터작은도서관(구 양천도서방),5600000,40000000,2800000,48400000
서울 강남구,푸르지오 책사랑,2346250,4734500,4404870,11485620
서울 동작구,푸른 도서관,300000,0,2100000,2400000
서울 광진구,푸른꿈 도서관,1000000,0,1500000,2500000
서울 구로구,푸른꿈북카페,1000000,0,0,1000000
서울 구로구,푸른꿈작은도서관,0,0,0,0
서울 양천구,푸른나래어린이도서관,3000000,35000000,7300000,45300000
서울 양천구,푸른마을해바라기작은도서관(푸른마을1단지),1200000,0,0,1200000
서울 노원구,푸른숲작은도서관,4200000,0,3200000,7400000
서울 은평구,푸른작은도서관,4400000,0,5000000,9400000
서울 은평구,푸른풀밭 작은도서관,1500000,0,3000000,4500000
서울 마포구,풀뿌리문고,0,0,800000,800000
서울 송파구,풍납1동새마을문고,2400000,0,2000000,4400000
서울 구로구,풍성한 어린이 영어작은 도서관,500000,0,1500000,2000000
서울 은평구,풍성한알곡비젼도서관,1000000,0,0,1000000
서울 중구,필동 새마을작은도서관,4968000,11988000,3380000,20336000
서울 강서구,하늘꿈 문고,3800000,0,2600000,6400000
서울 동대문구,하늘꿈문고,0,0,0,0
서울 마포구,하늘꿈작은도서관,0,0,0,0
서울 구로구,하늘마루 작은도서관(천왕 5단지),2900000,0,1200000,4100000
서울 동작구,하늘사다리문고,4000000,0,0,4000000
서울 서대문구,하늘샘어린이도서관,8000000,0,9100000,17100000
서울 강북구,하늘씨앗작은도서관,2000000,0,0,2000000
서울 노원구,하늘작은도서관,4200000,0,5220000,9420000
서울 종로구,하늘폭포 도서관,3798000,0,2299000,6097000
서울 노원구,하늘품작은도서관,2020000,1200000,3180000,6400000
서울 노원구,한길문고,7700000,6300000,24000000,38000000
서울 강서구,한길문고,4000000,0,4700000,8700000
서울 영등포구,한믿음도서관,0,0,1000000,1000000
서울 마포구,한사랑문고,3000000,0,0,3000000
서울 양천구,한사랑작은도서관,12000000,14400000,1000000,27400000
서울 동작구,한숲문고,4543890,3100000,103590,7747480
서울 성북구,한신휴(아)북카페,4640000,8400000,15260000,28300000
서울 송파구,한아람 작은도서관,960000,0,240000,1200000
서울 양천구,한어울터(신정이펜4단지),1800000,0,0,1800000
서울 구로구,한우리 독서문화원,600000,0,0,600000
서울 노원구,한울문고,0,3600000,0,3600000
서울 중랑구,한울샘어린이도서관,2200000,0,1000000,3200000
서울 노원구,한울작은도서관,6200000,0,5220000,11420000
서울 관악구,한울타리도서관,2000000,0,1520000,3520000
서울 강동구,함께크는우리,3000000,19678390,45250870,67929260
서울 영등포구,함께하는문고,300000,0,1200000,1500000
서울 관악구,해성작은도서관,2203210,0,0,2203210
서울 노원구,해솔작은도서관,4200000,0,5220000,9420000
서울 마포구,해오름 문고,2000000,200000,760000,2960000
서울 강동구,해오름 작은도서관,7375000,2400000,4400000,14175000
서울 금천구,해오름 작은도서관,2645850,2709000,1953760,7308610
서울 마포구,해오름작은도서관,6200000,18600000,12329840,37129840
서울 용산구,햇빛꿈이있는도서관,1400000,0,500000,1900000
서울 서대문구,햇살도서관,2368750,0,300000,2668750
서울 은평구,햇살이 따뜻한 아이마루도서관,2703000,1990590,1039410,5733000
서울 강동구,햇살작은도서관,4375000,0,800000,5175000
서울 성동구,행당2동 어린이 작은도서관,3118400,0,0,3118400
서울 서대문구,행복작은도서관,2379740,0,300000,2679740
서울 구로구,행복한 작은도서관,3500000,0,3600000,7100000
서울 양천구,행복한도서관,300000,0,1000000,1300000
서울 관악구,행운동 마루 작은도서관,4278385,0,3400000,7678385
서울 송파구,헤브론,3200000,800000,1200000,5200000
서울 동작구,헤브론문고,2000000,0,0,2000000
서울 종로구,혜성이야기 도서관,1600000,600000,0,2200000
서울 종로구,혜화마을 북카페,2000000,12600000,0,14600000
서울 서대문구,호반재꿈작은도서관,2173830,0,300000,2473830
서울 종로구,홍파랑 북카페,2000000,12600000,0,14600000
서울 강서구,화곡 푸르지오 도서관,3000000,0,6600000,9600000
서울 강서구,화성교회작은도서관,1000000,0,0,1000000
서울 광진구,화양동 새마을작은도서관,2030000,0,4560000,6590000
서울 강서구,환원어린이작은도서관,2000000,0,5000000,7000000
서울 중구,황학동 새마을작은도서관,2968000,11988000,4480000,19436000
서울 동대문구,회기동 꿈자람 작은도서관,0,0,0,0
서울 중구,회현동 작은도서관,2968000,11988000,1800000,16756000
서울 은평구,효경골 마을문고,1232000,1794880,205120,3232000
서울 용산구,효창독서마당,2000000,0,0,2000000
서울 용산구,효창사랑작은도서관,3099500,0,1373410,4472910
서울 용산구,후암동 북&캠프,3800000,0,2200000,6000000
서울 동대문구,휘경1동 새싹마루 작은도서관,0,0,1265000,1265000
서울 동대문구,휘경2동 꿈빛누리 작은도서관,0,0,420000,420000
서울 송파구,휴피아작은도서관,500000,1000000,1000000,2500000
서울 동작구,흑석동마을문고,0,0,0,0
서울 강서구,희망문고,1613000,0,5387000,7000000
세종 ,금남 작은도서관,2400000,0,5000000,7400000
세종 ,부강 작은도서관,3000000,0,4500000,7500000
세종 ,세종e편한세상아파트 작은도서관,0,0,0,0
세종 ,소정작은도서관,6000000,5000000,9000000,20000000
세종 ,이편한 작은도서관,2000000,0,5000000,7000000
세종 ,전의도래샘 작은도서관,4500000,8400000,900000,13800000
세종 ,첫마을아파트 1단지 작은도서관,0,0,0,0
세종 ,푸른나무 작은도서관,3000000,0,5900000,8900000
세종 ,푸른작은도서관,300000,0,150000,450000
울산 북구,LG문화공간,0,0,400000,400000
울산 울주군,가지산도서관,3000000,16301040,1981960,21283000
울산 북구,고맙습니다북구다문화작은도서관,2000000,50000000,20000000,72000000
울산 울주군,교동리슈빌,2000000,0,1200000,3200000
울산 울주군,굴화강변월드메르디앙,2400000,0,0,2400000
울산 북구,극동푸른문화공간,3000000,0,0,3000000
울산 동구,꽃바위작은도서관,22340000,45379000,23919000,91638000
울산 북구,꿈꾸는작은도서관,3000000,0,11120000,14120000
울산 남구,꿈나래작은도서관,1000000,0,0,1000000
울산 울주군,꿈나무,3200000,0,600000,3800000
울산 중구,꿈나무어린이문고,1000000,0,0,1000000
울산 동구,꿈샘도서관,1000000,0,0,1000000
울산 북구,꿈쟁이작은도서관,2000000,0,4960470,6960470
울산 중구,꿈틀꿈틀작은도서관,1500000,4800000,3600000,9900000
울산 동구,남목작은도서관,22340000,45379500,23918000,91637500
울산 중구,남외 별빛 작은도서관,150000,3600000,600000,4350000
울산 중구,남외푸르지오문고,1200000,1200000,1200000,3600000
울산 울주군,느티나무,2996450,16319120,1998840,21314410
울산 울주군,늘푸름,3000000,17261000,2000000,22261000
울산 중구,다난작은도서관,0,2400000,0,2400000
울산 북구,다울림작은도서관,7000000,6000000,2400000,15400000
울산 중구,단장골북카페,8072850,14310930,0,22383780
울산 울주군,대안현대,2000000,0,800000,2800000
울산 남구,대현동 마을문고,5000000,0,0,5000000
울산 울주군,동문굿모닝힐푸른,2000000,0,360000,2360000
울산 울주군,동문햇살,720000,0,280000,1000000
울산 울주군,동백도서관,3000000,0,0,3000000
울산 울주군,동원,2000000,0,0,2000000
울산 남구,드림작은도서관,800000,0,0,800000
울산 북구,뚜벅이작은도서관,1000000,55984050,3199960,60184010
울산 동구,로뎀나무작은도서관,2000000,0,0,2000000
울산 남구,마이코즈문고,800000,0,0,800000
울산 동구,맑은숲작은도서관,1000000,0,0,1000000
울산 북구,매곡영어도서관,500000,0,0,500000
울산 북구,명랑작은도서관,0,0,0,0
울산 북구,명촌문고,0,0,2000000,2000000
울산 남구,무거동 마을문고,6500000,0,0,6500000
울산 울주군,미도파,2000000,0,0,2000000
울산 남구,미소나눔도서관,4000000,0,4200000,8200000
울산 동구,바다가 보이는 작은도서관,1000000,2361330,0,3361330
울산 남구,바른아이어린이도서관,800000,0,0,800000
울산 울주군,범서,3000000,17261000,2000000,22261000
울산 울주군,보물섬,2000000,0,2400000,4400000
울산 울주군,봉화,2000000,0,0,2000000
울산 울주군,빛가람,2000000,0,0,2000000
울산 남구,삼산동 마을문고,5500000,0,0,5500000
울산 동구,상록수독서문화원,1000000,0,0,1000000
울산 남구,선암동 마을문고,6500000,0,0,6500000
울산 중구,세린작은도서관,15280826,18000000,21150450,54431276
울산 남구,소풍작은도서관,1000000,0,0,1000000
울산 중구,솔로몬도서관,600000,0,2500000,3100000
울산 남구,수암동 마을문고,6500000,0,0,6500000
울산 남구,수암지역아동센터 문고,600000,0,0,600000
울산 울주군,숲속문고,2000000,0,150000,2150000
울산 남구,신선산휴먼빌도서관,600000,0,0,600000
울산 중구,신월도서관,5236700,0,0,5236700
울산 남구,신정2동 마을문고,5000000,0,0,5000000
울산 남구,신정3동 마을문고,5000000,0,0,5000000
울산 남구,신정4동 마을문고,5500000,0,0,5500000
울산 울주군,아너스빌,480000,0,1320000,1800000
울산 북구,아름드리작은도서관,2317800,3000000,13140240,18458040
울산 동구,아우름쉼터 북카페,0,0,0,0
울산 남구,야음롯데캐슬도서관,800000,0,0,800000
울산 북구,양정작은도서관,3000000,6000000,12000000,21000000
울산 북구,양정힐스테이트2차문고,0,0,0,0
울산 중구,어깨동무도서관,0,0,0,0
울산 울주군,어울림,2000000,960000,1440000,4400000
울산 중구,에일린의뜰문고,0,0,0,0
울산 북구,엠코가온누리작은도서관,3000000,6000000,2400000,11400000
울산 울주군,여울목,4300000,0,1200000,5500000
울산 울주군,열린,2000000,700000,0,2700000
울산 북구,열린어린이문고,200000,0,150000,350000
울산 중구,옥골샘작은도서관,1596640,14783130,19540000,35919770
울산 남구,옥현주공1단지책마루,600000,0,0,600000
울산 남구,옥현주공2단지문고,800000,0,0,800000
울산 남구,우리들만의공간,800000,0,0,800000
울산 중구,우암작은도서관,3000000,0,2520000,5520000
울산 중구,우정아이파크작은도서관,400000,0,7200000,7600000
울산 남구,울산감리교회문고,600000,0,0,600000
울산 울주군,웅촌,3000000,15017360,1905710,19923070
울산 북구,월드시티1 작은도서관,120000,0,120000,240000
울산 북구,월드시티2 작은도서관,2885000,0,0,2885000
울산 남구,월봉도서관,10000000,66629000,36270000,112899000
울산 중구,유곡푸르지오책마루도서관,0,0,0,0
울산 울주군,은행나무,3000000,0,400000,3400000
울산 동구,작은도서관 더불어숲,1550000,16320000,52800000,70670000
울산 중구,작은도서관 책마을,1956000,16000000,9180000,27136000
울산 남구,재밌는도서관,600000,0,0,600000
울산 동구,전하작은도서관,22340000,45379000,26914000,94633000
울산 북구,정자작은도서관,2220770,0,0,2220770
울산 중구,중부 우리들 작은도서관,4000000,5000000,12000000,21000000
울산 울주군,지혜샘터,1800000,0,2700000,4500000
울산 북구,책가방작은도서관,2700000,6000000,2400000,11100000
울산 북구,책놀이터작은도서관,2872500,6000000,3600000,12472500
울산 북구,책누리작은도서관,3000000,6000000,2400000,11400000
울산 북구,책마루작은도서관,4855520,6000000,2400000,13255520
울산 북구,책사랑작은도서관,2529140,6000000,3000000,11529140
울산 중구,책의숲,1500000,0,0,1500000
울산 울주군,청운,2000000,3000000,2040000,7040000
울산 동구,초록우산북카페,3000000,0,707290,3707290
울산 동구,크레파스 작은도서관,1000000,6000000,500000,7500000
울산 울주군,큰꿈,2000000,0,750000,2750000
울산 동구,큰빛우리들문고,0,0,0,0
울산 중구,태화루도서관,17187100,29035320,20940000,67162420
울산 중구,페다고지,1200000,0,1500000,2700000
울산 울주군,푸르지오,6800000,1200000,5520000,13520000
울산 동구,푸르지오작은도서관,0,19600000,654450,20254450
울산 울주군,푸른,2700000,0,900000,3600000
울산 남구,푸른도서관,800000,0,0,800000
울산 북구,푸른작은도서관,3898560,6000000,4800000,14698560
울산 중구,학성작은도서관,0,0,0,0
울산 울주군,한누리,3000000,0,0,3000000
울산 동구,한마음도서관,850,92000,91500,184350
울산 중구,함월도서관,99491390,11858080,8560000,119909470
울산 동구,해누리문고,1000000,1000000,0,2000000
울산 울주군,해보리,2000000,0,720000,2720000
울산 북구,해솔작은도서관,3500000,0,100000,3600000
울산 울주군,해오름,3000000,17260000,2000000,22260000
울산 중구,해오름작은도서관,0,0,0,0
울산 울주군,햇빛,2000000,0,0,2000000
울산 북구,햇살작은도서관,2883180,6000000,3600000,12483180
울산 울주군,호반숲속,2000000,0,0,2000000
울산 북구,화봉휴먼시아 문화공간,3200000,0,1800000,5000000
울산 동구,화정작은도서관,22340000,22689500,24918000,69947500
울산 울주군,황금똥,3000000,0,9600000,12600000
울산 동구,휴(休) Book 사랑방,1000000,0,0,1000000
울산 남구,휴(休)작은도서관,800000,0,0,800000
인천 서구,가재울 작은도서관,0,9600000,0,9600000
인천 서구,가정골 북카페,2000000,3960000,1000000,6960000
인천 부평구,갈산밀알도서관,1800000,8280000,913000,10993000
인천 서구,거북골 작은도서관,0,8400000,0,8400000
인천 서구,건지골 마을문고,5000000,0,0,5000000
인천 서구,검4랑 꿈도서관,5000000,5280000,0,10280000
인천 서구,검단3동 작은도서관,5000000,0,0,5000000
인천 동구,고맙습니다솔향기작은도서관,800000,0,2500000,3300000
인천 계양구,고양골책둥지도서관,2500000,6000000,0,8500000
인천 동구,골목작은도서관,1250000,6000000,2000000,9250000
인천 남동구,광성독서클럽,1000000,500000,0,1500000
인천 강화군,교동화개작은도서관,3996700,0,443210,4439910
인천 남동구,그루터기도서관,6000000,0,3600000,9600000
인천 연수구,글담 작은도서관,1679819,0,4328697,6008516
인천 연수구,글마루,3000000,0,1400000,4400000
인천 부평구,글마루도서관,0,13800000,2911000,16711000
인천 서구,금곡하나아파트 문고,0,0,0,0
인천 계양구,길벗어린이도서관,5065400,0,20769222,25834622
인천 강화군,길상면 작은도서관,4000000,13800000,500000,18300000
인천 남동구,"길위의 꿈, 여행인문학도서관",12000000,20000000,12000000,44000000
인천 계양구,까치말도서관,0,8085000,0,8085000
인천 계양구,꾸메땅 작은도서관,0,1100000,500000,1600000
인천 서구,꿈꾸는 나무 도서관 ,600000,0,50000,650000
인천 남동구,꿈꾸는 도서관,500000,0,200000,700000
인천 남구,꿈꾸는 문고,150000,0,6000000,6150000
인천 서구,꿈꾸는 작은도서관,884990,0,0,884990
인천 남동구,꿈꾸는 작은도서관 가온누리,10000000,12000000,6000000,28000000
인천 서구,꿈꾸미 문고,0,0,1200000,1200000
인천 중구,꿈나래 어린이도서관,15100000,4000000,17100000,36200000
인천 서구,꿈나무 작은도서관,5000000,0,0,5000000
인천 남동구,꿈나무도서관,3000000,1200000,10700000,14900000
인천 계양구,꿈나무작은도서관,300000,0,700000,1000000
인천 부평구,꿈나무작은도서관,0,7560000,500000,8060000
인천 남동구,꿈다락도서관,2000000,3240000,4650000,9890000
인천 서구,꿈드림 작은도서관 ,1200000,0,0,1200000
인천 남구,꿈드림작은도서관,300000,21200000,6000000,27500000
인천 부평구,꿈땅 도서관,4197830,1581000,9107670,14886500
인천 서구,꿈마을 작은도서관,1000000,0,500000,1500000
인천 남구,꿈바라기 영어도서관,500000,1500000,500000,2500000
인천 서구,꿈사랑 작은도서관 ,0,0,1440000,1440000
인천 남동구,꿈사랑나눔 작은도서관,0,0,0,0
인천 동구,꿈의별작은도서관,0,0,0,0
인천 부평구,꿈이 있는 도서관,300000,0,200000,500000
인천 연수구,꿈이있는 작은도서관,4000000,0,940910,4940910
인천 계양구,꿈이있는 작은도서관,1870000,0,22680000,24550000
인천 동구,꿈이크는작은도서관,0,0,0,0
인천 남동구,나무와책도서관,1000000,0,0,1000000
인천 부평구,누리보듬마을문고,200000,0,3689440,3889440
인천 서구,느티나무 문고,2000000,0,0,2000000
인천 부평구,늘푸른도서관,3537040,6000000,1364900,10901940
인천 연수구,늘푸른어린이도서관,5000000,5000000,17800000,27800000
인천 중구,단비도서관,6375000,1302600,4461750,12139350
인천 남동구,단풍마을 작은도서관,1500000,0,1500000,3000000
인천 부평구,달팽이미디어도서관,3435860,18800000,54262993,76498853
인천 연수구,더드림(The Dream)작은도서관,2800000,0,16000000,18800000
인천 남동구,도림도서관,0,0,0,0
인천 남구,도화꿈꾸는작은도서관,3000000,12000000,6000000,21000000
인천 계양구,돌멩이국도서관,5500000,4000000,10200000,19700000
인천 부평구,동그라미도서관,0,480000,120000,600000
인천 남구,동반작은도서관,1000000,800000,1000000,2800000
인천 부평구,동수작은도서관,0,12500000,620000,13120000
인천 중구,동인천동 작은도서관,0,4680000,1000000,5680000
인천 서구,드림파크 어울림 1단지 문고 ,470000,112000,1533000,2115000
인천 서구,드림하이 작은도서관,0,0,470000,470000
인천 남동구,등대문고,0,0,0,0
인천 남동구,등마루도서관,8000000,18945000,2735200,29680200
인천 부평구,로뎀나무 문고,0,0,0,0
인천 남동구,롯데캐슬작은도서관,4647540,21843600,6098170,32589310
인천 부평구,마을도서관,0,0,150000,150000
인천 남동구,마을안 작은도서관,1000000,0,5000000,6000000
인천 남동구,마중물도서관,4747160,0,14468790,19215950
인천 동구,만석비치타운작은도서관,3000000,600000,100000,3700000
인천 남동구,만수3동작은도서관,3000000,6000000,1300000,10300000
인천 남동구,만수4동둥지도서관,3000000,5760000,1000000,9760000
인천 연수구,목민작은도서관,4500000,1920000,2080000,8500000
인천 부평구,무지개도서관,2000000,2400000,800000,5200000
인천 계양구,무지개뜨는어린이도서관,2500000,0,0,2500000
인천 서구,물푸레 작은도서관,1000000,9000000,2400000,12400000
인천 서구,미추홀 작은도서관 ,2000000,0,300000,2300000
인천 부평구,민들레 작은도서관,4299840,0,1800000,6099840
인천 연수구,민들레문고,2000000,0,0,2000000
인천 서구,민들레작은도서관,0,0,269510,269510
인천 강화군,바람숲그림책도서관,3600000,60000000,12000000,75600000
인천 남동구,반디어린이도서관,4000000,14400000,24000000,42400000
인천 남구,반딧불이 도서관,2400000,1200000,3000000,6600000
인천 부평구,반석 작은도서관,0,0,0,0
인천 남구,밝은웃음어린이도서관,600000,10200000,2530000,13330000
인천 서구,백합책마을 문고,0,0,2000000,2000000
인천 남동구,범마을도서관,0,0,0,0
인천 남동구,벽산도서관,1000000,30000000,2000000,33000000
인천 남동구,별빛마을도서관,3726000,0,2400000,6126000
인천 남동구,복E지문고,4000000,0,100000,4100000
인천 남구,복사꽃도서관,10000000,13500000,5000000,28500000
인천 연수구,북센터,2698200,22861660,1301800,26861660
인천 남동구,불서사랑도서관,200,0,100,300
인천 강화군,사과나무작은도서관,0,0,0,0
인천 서구,사닥다리 북카페 문고,4500000,0,500000,5000000
인천 서구,사랑의 작은도서관 북카페,5000000,5160000,0,10160000
인천 부평구,산곡글향기도서관,0,8410000,5630000,14040000
인천 남동구,산돌문고,1000000,0,500000,1500000
인천 남동구,산뒤마을작은도서관,1000000,0,500000,1500000
인천 남구,상떼빌도서관,200000,0,0,200000
인천 동구,상상작은도서관,1000000,0,1000000,2000000
인천 서구,새일꾼 작은도서관,1000000,1200000,100000,2300000
인천 부평구,샘터작은도서관,0,3000000,1344000,4344000
인천 계양구,샛별도서관,0,8860000,0,8860000
인천 서구,서인천월드메르디앙 문고,920080,2000000,112100,3032180
인천 남동구,서창11단지 작은도서관,200,0,0,200
인천 남구,석바위도서관,10000000,30000000,5000000,45000000
인천 계양구,선한목자교회작은도서관,100000,0,100000,200000
인천 남동구,선향비전도서관,700000,0,800000,1500000
인천 남동구,성산도서관,967000,0,100000,1067000
인천 연수구,성지리벨루스도서관,4600000,0,150000,4750000
인천 남구,소금꽃도서관,15000000,32000000,5000000,52000000
인천 남구,솔로몬문고,1000000,0,1740000,2740000
인천 동구,솔방울작은도서관,500000,3000000,150000,3650000
인천 동구,솔숲작은도서관,0,20000000,770000,20770000
인천 서구,솔지마을 문고,1000000,0,2000000,3000000
인천 연수구,송도2동 작은도서관,10000000,22590000,5650000,38240000
인천 동구,송림마을작은도서관,0,0,0,0
인천 동구,송림휴먼시아작은도서관,0,10000000,0,10000000
인천 서구,수정 작은도서관 ,5000000,12000000,4000000,21000000
인천 강화군,순무작은도서관,0,0,0,0
인천 남동구,숲속마을작은도서관,700000,0,2400000,3100000
인천 부평구,신나는 도서관,1540000,3370000,20343980,25253980
인천 부평구,쑥덕쑥덕 작은도서관,3600000,12000000,2400000,18000000
인천 동구,아침햇살작은도서관,0,10000000,9000000,19000000
인천 부평구,아카데미 작은도서관,0,0,840,840
인천 서구,어질내 문고,100000,0,0,100000
인천 연수구,엄마사랑 작은도서관,2967660,0,5400000,8367660
인천 남동구,에임하이 작은도서관,5000000,500000,500000,6000000
인천 남동구,에코메트로11단지도서관,871470,10500000,0,11371470
인천 남동구,에코메트로한화12단지 도서관,1000000,19000000,1600000,21600000
인천 부평구,엘림작은도서관,2300000,0,1500000,3800000
인천 연수구,연수2동 작은도서관,0,18750000,2500000,21250000
인천 서구,연희주민 문고,2000000,0,0,2000000
인천 남동구,예꿈마을문고,1000000,0,0,1000000
인천 남구,예꿈어린이도서관,0,0,10000000,10000000
인천 남동구,예다원도서관,5000000,1000000,30000000,36000000
인천 남구,오라작은도서관,300000,0,1800000,2100000
인천 연수구,옥련1동작은도서관,15000000,18750000,7439660,41189660
인천 연수구,옥련2동 어린이 작은도서관,12538000,29640000,3217280,45395280
인천 부평구,옹달샘 도서관,1200000,0,5000000,6200000
인천 남동구,와글와글작은도서관,2000000,4800000,4800000,11600000
인천 중구,용유동 작은도서관,2000000,5000000,0,7000000
인천 남구,우각로문화마을 행복도서관,500000,5000000,5000000,10500000
인천 강화군,우리동네 영어도서관,0,0,0,0
인천 서구,원당 작은 영어도서관 ,5000000,0,3600000,8600000
인천 계양구,은행마을도서관,2500000,8750000,0,11250000
인천 강화군,자람도서관,3800000,7940000,14140000,25880000
인천 남동구,자람터작은도서관,2800000,200000,2400000,5400000
인천 연수구,작은도서관 너나들이,4396410,1200000,14011645,19608055
인천 연수구,작은도서관 완두콩,9000000,0,4000000,13000000
인천 서구,정다운 도서관,4000000,19473000,14004000,37477000
인천 남구,제물포도서관,7275838,0,5000000,12275838
인천 연수구,조약돌 북센터,3675730,1501000,6379200,11555930
인천 서구,조은생각 BOOK CAFE,5000000,0,0,5000000
인천 연수구,지혜샘터 작은도서관,2426000,0,4974000,7400000
인천 계양구,지혜의숲도서관,0,0,0,0
인천 연수구,짱뚱이어린이도서관,1200000,4800000,10500000,16500000
인천 강화군,창의짱 작은도서관,0,0,0,0
인천 부평구,청개구리어린이도서관,2839870,10000000,6673624,19513494
인천 서구,청라 책나누미 CAFE,43920000,0,0,43920000
인천 부평구,청소년인문학도서관 doing,3165200,14920000,11164890,29250090
인천 서구,청소년인문학도서관 느루,100000,1200000,1800000,3100000
인천 남구,청운 꿈나무 문고,2000000,0,1000000,3000000
인천 남동구,콩세알도서관,6500000,8400000,19100000,34000000
인천 남구,큰나무도서관,1946550,34446640,23346469,59739659
인천 남동구,큰사랑도서관,800000,0,8900000,9700000
인천 남동구,푸르내도서관,1000000,0,2600000,3600000
인천 서구,푸른꿈 작은도서관 ,1500000,0,1200000,2700000
인천 연수구,푸른마을함박도서관,6528050,12341723,24485084,43354857
인천 서구,푸른샘 어린이도서관,5000000,0,0,5000000
인천 남동구,푸른솔도서관,0,0,250000,250000
인천 서구,푸른숲 작은도서관,500000,8400000,4000000,12900000
인천 동구,푸른숲작은도서실,0,0,0,0
인천 계양구,푸른초장문고,4500000,16250000,2500000,23250000
인천 서구,풀뿌리 미디어 도서관,1000000,2400000,5600000,9000000
인천 부평구,품앗이어린이도서관,410000,4800000,10800000,16010000
인천 중구,하늘꿈 작은도서관,0,0,0,0
인천 남구,하늘꿈도서관,3500000,0,1500000,5000000
인천 남구,하늘문고,1000000,0,2000000,3000000
인천 남동구,하늘문고,2000000,2400000,358190,4758190
인천 서구,하늘샘 작은도서관,1500000,0,1000000,2500000
인천 강화군,하점작은도서관,4000000,0,2500000,6500000
인천 계양구,학마을도서관,0,0,0,0
인천 서구,한국민들레도서관,4500000,6000000,9500000,20000000
인천 남동구,한마음도서관,4800000,0,3600000,8400000
인천 남구,한소망작은도서관,700000,1500000,5000000,7200000
인천 남동구,한화에코메트로5단지도서관,2250000,0,480000,2730000
인천 부평구,해뜨는마을 도서관,0,1000000,1000000,2000000
인천 동구,해맑은작은도서관,360000,3600000,0,3960000
인천 연수구,해맑음 작은도서관,1200000,4940000,600000,6740000
인천 연수구,해모로 도서관,0,0,556420,556420
인천 부평구,해오름 작은도서관,1019100,0,1388630,2407730
인천 남동구,햇살둥지어린이도서관,3950000,0,2866980,6816980
인천 동구,햇살마루작은도서관,3600000,12000000,0,15600000
인천 서구,행복한나라 문고,0,0,0,0
인천 남동구,행복한작은도서관,1000000,0,15000000,16000000
인천 남동구,향촌작은도서관,2000000,13920000,3400000,19320000
인천 남동구,향촌휴먼시아2단지작은도서관,0,0,0,0
인천 중구,현안 작은도서관,0,30000000,2400000,32400000
인천 강화군,화도작은도서관 ,5000000,0,2500000,7500000
인천 서구,회화나무 도서관,5000000,5160000,3600000,13760000
인천 연수구,효민작은도서관,0,0,200000,200000
인천 중구,휘란 작은도서관,0,9800000,1000000,10800000
인천 부평구,희망천작은도서관,0,12480000,7424000,19904000
인천 서구,힐데스 작은도서관 ,0,0,0,0
전남 영암군,119작은도서관,2000000,0,0,2000000
전남 신안군,wonderful English작은도서관,300000,0,2000000,2300000
전남 순천시,가곡옹달샘,2000000,6240000,1200000,9440000
전남 담양군,강의새마을문고,0,0,600000,600000
전남 여수시,개도 작은도서관,2300000,6000000,500000,8800000
전남 무안군,경남아너스빌 아파트 작은도서관,0,0,0,0
전남 나주시,공산면작은도서관,1250000,0,0,1250000
전남 고흥군,과역거쳐가는작은도서관,19841480,17863000,12907000,50611480
전남 장흥군,관산읍작은독서실,928570,0,0,928570
전남 여수시,광림작은도서관,2600000,6000000,2523430,11123430
전남 광양시,광양시민도서문화원,1500000,0,2500000,4000000
전남 구례군,구례중앙문고,1000000,0,0,1000000
전남 곡성군,구름다리 작은도서관,1300000,0,0,1300000
전남 무안군,구세군독서실,1000000,0,0,1000000
전남 여수시,그리스도작은도서관,1300000,0,0,1300000
전남 광양시,그린 작은도서관,0,0,0,0
전남 고흥군,그린나래작은도서관,0,0,0,0
전남 무안군,근화베아채 작은도서관,0,2370000,376720,2746720
전남 광양시,금호작은도서관,4000000,6000000,1200000,11200000
전남 곡성군,길 작은 도서관,1300000,0,2000000,3300000
전남 여수시,꿈꾸는 영어전문 작은도서관,3167625,6000000,1333180,10500805
전남 보성군,꿈꾸는 작은도서관(청소년문화의집내),1000000,36000000,1000000,38000000
전남 순천시,꿈꾸는숲속의작은도서관,2375000,6240000,1940000,10555000
전남 나주시,꿈꾸는작은도서관,500000,0,0,500000
전남 순천시,꿈나래작은도서관,4000000,8280000,2000000,14280000
전남 화순군,꿈나무도서관,0,0,0,0
전남 목포시,꿈나무작은도서관,1500000,20175000,14470000,36145000
전남 목포시,꿈돌이작은도서관,1500000,18922000,20412000,40834000
전남 여수시,꿈을키우는 작은도서관,4069560,15600000,8943620,28613180
전남 나주시,꿈이있는 나주교회작은도서관,0,0,0,0
전남 무안군,꿈이있는 문고,100000,0,0,100000
전남 강진군,꿈이있는아동문고,0,0,0,0
전남 영광군,낙월작은도서관,0,0,673470,673470
전남 무안군,남악아이파크작은도서관,1600000,3600000,800000,6000000
전남 무안군,남악주공2단지 작은도서관,0,0,0,0
전남 순천시,남양휴튼작은도서관,0,0,0,0
전남 순천시,남제자치,1000000,6240000,1200000,8440000
전남 곡성군,녹색문고,1300000,0,0,1300000
전남 광양시,농부네텃밭도서관,0,0,0,0
전남 화순군,느티나무마을도서관,0,1000000,13960000,14960000
전남 화순군,늘푸른문고,960000,0,7000000,7960000
전남 장성군,다니엘작은도서관,1500000,500000,500000,2500000
전남 보성군,다보리 작은도서관(보성문화원내),2000000,24000000,1000000,27000000
전남 화순군,다사랑문고,2000000,0,7400000,9400000
전남 광양시,다은작은도서관,0,0,0,0
전남 화순군,달빛작은도서관,0,0,0,0
전남 강진군,대구 작은도서관,0,0,0,0
전남 담양군,대덕문고(도서관),0,0,1500000,1500000
전남 광양시,대림 미리내 작은도서관,4000000,6000000,1200000,11200000
전남 나주시,대방반딧불작은도서관,1250000,0,0,1250000
전남 순천시,대주2차푸른솔작은도서관,2000000,6240000,1200000,9440000
전남 무안군,덕치도서관,0,0,0,0
전남 강진군,도룡문고,0,0,0,0
전남 신안군,도초작은도서관,0,16190000,3225000,19415000
전남 고흥군,도화 푸른꿈 작은도서관,19841000,17000000,12016000,48857000
전남 완도군,동고교회문고,0,0,0,0
전남 광양시,동광양 중부 작은도서관,0,0,0,0
전남 광양시,동광양평화문고,0,0,0,0
전남 순천시,동신별빛작은도서관,2000000,6240000,2240000,10480000
전남 순천시,두산위브행복작은도서관,300000,700000,500000,1500000
전남 해남군,디딤돌문고,500000,0,1500000,2000000
전남 여수시,로얄골드빌아파트 작은도서관,1800000,3000000,600000,5400000
전남 순천시,롯데캐슬나눔작은도서관,3000000,7200000,3000000,13200000
전남 해남군,마산신기문고,0,0,0,0
전남 화순군,마중물작은도서관,0,0,0,0
전남 순천시,매곡자치작은도서관,2375000,6240000,1020000,9635000
전남 광양시,매화반딧불작은도서관,4000000,6000000,1200000,11200000
전남 목포시,모아엘가작은도서관,0,0,0,0
전남 여수시,목양작은도서관,1300000,0,0,1300000
전남 광양시,무등작은도서관,4000000,6000000,1200000,11200000
전남 목포시,무지개작은도서관,1500000,18620000,13126000,33246000
전남 여수시,민들레작은도서관,2600000,14400000,6900000,23900000
전남 목포시,반딧불작은도서관,1500000,22475000,11200000,35175000
전남 나주시,배꽃작은도서관,1250000,0,0,1250000
전남 영광군,백수작은도서관,3826300,0,3548610,7374910
전남 해남군,백호문고,0,6000000,2000000,8000000
전남 영광군,법성작은도서관,4841200,7093498,5365020,17299718
전남 순천시,별량첨산작은도서관,2375000,7080000,1870000,11325000
전남 고흥군,봉래 한빛 작은도서관,19841470,12270000,11270000,43381470
전남 담양군,봉산문고(봉산지역아동센터),0,0,1000000,1000000
전남 순천시,봉화호롱불작은도서관,2000000,6240000,1200000,9440000
전남 나주시,봉황면작은도서관,1250000,0,0,1250000
전남 장흥군,부산면 작은독서실,928570,0,0,928570
전남 나주시,비단고을용문작은도서관,500000,0,0,500000
전남 광양시,빛광양도서관,0,0,0,0
전남 화순군,빛나라도서관,250000,3300000,1440000,4990000
전남 무안군,사랑으로열린(작은)도서관,0,0,0,0
전남 강진군,산내들 지역아동센타,480000,0,0,480000
전남 구례군,산동제일교회문고,1700000,0,600000,2300000
전남 여수시,삼일우리도서관,1700000,0,500000,2200000
전남 영암군,삼호벧엘작은도서관,1592430,300000,0,1892430
전남 순천시,상사용암,2500000,7080000,1200000,10780000
전남 광양시,새마을꿈나무 작은도서관,0,0,600000,600000
전남 광양시,새마을문고 늘푸른도서관,0,0,0,0
전남 여수시,샘뿔인문학연구소작은도서관,2100000,500000,1300000,3900000
전남 나주시,샘터작은도서관,500000,0,0,500000
전남 장성군,샬롬작은도서관,0,0,5000,5000
전남 순천시,서면자치작은도서관,2000000,6240000,1200000,9440000
전남 곡성군,석청도서관,1300000,0,0,1300000
전남 화순군,세빛도서관,2690000,0,0,2690000
전남 광양시,송보 영어 작은 도서관,4000000,6000000,1200000,11200000
전남 광양시,송보꿈사랑도서관,1200000,0,600000,1800000
전남 순천시,송촌 글마루작은도서관,2375000,6240000,1102000,9717000
전남 순천시,순천만작은도서관,2000000,6240000,1200000,9440000
전남 순천시,순천생각나무작은도서관,2000000,6240000,1200000,9440000
전남 순천시,순천시호두작은도서관,2000000,7080000,600000,9680000
전남 순천시,순천용오름작은도서관,2000000,6120000,1200000,9320000
전남 목포시,숲속작은도서관,25000000,2400000,1146000,28546000
전남 순천시,승주꿈꾸는,2000000,6240000,1200000,9440000
전남 여수시,신기작은도서관,1300000,0,0,1300000
전남 순천시,신대중흥글마루작은도서관,0,0,0,0
전남 무안군,신동아파밀리에문고,0,0,0,0
전남 해남군,신방마을문고,0,0,0,0
전남 무안군,신성작은도서관,0,0,0,0
전남 순천시,신성풀꽃작은도서관,2000000,7080000,1200000,10280000
전남 순천시,신원푸른숲작은도서관,2000000,6240000,1200000,9440000
전남 완도군,신지햇살작은도서관,17456000,12764900,2235100,32456000
전남 곡성군,심청골 작은도서관,2800000,0,0,2800000
전남 곡성군,심청효문화센터 작은도서관,0,0,0,0
전남 광양시,써니벨리도서관,0,0,0,0
전남 여수시,씨티작은도서관,2500000,500000,3000000,6000000
전남 무안군,아낌없이주는나무 작은도서관,2000000,0,3600000,5600000
전남 나주시,아이뜰작은도서관,500000,0,0,500000
전남 여수시,아이와 엄마 작은도서관,1000000,6400000,4800000,12200000
전남 여수시,아주타운 작은도서관,2600000,6000000,900000,9500000
전남 화순군,안심작은도서관,0,0,5000000,5000000
전남 목포시,어깨동무작은도서관,0,0,0,0
전남 여수시,여서주공작은도서관,2600000,14400000,6900000,23900000
전남 여수시,여수중부작은도서관,2533520,6600000,183000,9316520
전남 목포시,연꽃작은도서관,1500000,18620000,7408000,27528000
전남 순천시,연동대주,2000000,6240000,2000000,10240000
전남 여수시,열린도서관,1300000,0,100000,1400000
전남 광양시,예닮문고,0,2300000,0,2300000
전남 나주시,오계작은도서관,500000,0,0,500000
전남 곡성군,오산독서회 작은도서관,1300000,0,0,1300000
전남 목포시,옥암꿈나무작은도서관,0,0,0,0
전남 목포시,옹달샘작은도서관,1500000,18415000,11430000,31345000
전남 완도군,완도제일작은도서관,100000,0,100000,200000
전남 순천시,왕조2동자치작은도서관,2000000,6240000,1020000,9260000
전남 순천시,우성반딧불작은도서관,2000000,520000,600000,3120000
전남 무안군,운남 에덴문고,0,0,0,0
전남 여수시,웅천지웰 작은도서관,2500000,4800000,2240000,9540000
전남 곡성군,원등교회문고,1300000,0,0,1300000
전남 여수시,원앙작은도서관,2600000,15300000,6000000,23900000
전남 무안군,원평산 작은도서관,2200000,0,0,2200000
전남 함평군,월야작은도서관,1171700,0,17837100,19008800
전남 장흥군,유치면 작은 도서실,928570,0,0,928570
전남 목포시,은하수작은도서관,1500000,18933000,18633000,39066000
전남 무안군,자람터 작은도서관,3336260,0,300000,3636260
전남 신안군,자은구영마을도서관,0,0,0,0
전남 순천시,작은나무작은도서관,2000000,6240000,2200000,10440000
전남 신안군,장산작은도서관,0,15881000,1748000,17629000
전남 여수시,장성도서관,1300000,0,0,1300000
전남 장흥군,장평면작은독서실,928570,0,0,928570
전남 장흥군,장흥 건산2차 휴먼시아 작은도서관,928570,0,0,928570
전남 순천시,저전자치작은도서관,2000000,6240000,1200000,9440000
전남 나주시,제일작은도서관,0,0,0,0
전남 순천시,조곡자치작은도서관,2000000,6240000,1100000,9340000
전남 순천시,조례금호작은도서관,2375000,6240000,1350000,9965000
전남 순천시,조례종합복지관 작은도서관,2000000,6240000,1200000,9440000
전남 강진군,좋은문고,0,0,0,0
전남 곡성군,주산문고,1300000,0,0,1300000
전남 순천시,주암광천작은도서관,2000000,6240000,1200000,9440000
전남 여수시,주은금호 작은도서관,2600000,6000000,900000,9500000
전남 곡성군,죽곡농민열린도서관,1300000,0,0,1300000
전남 여수시,중앙작은도서관,1400000,0,0,1400000
전남 신안군,증도작은도서관,0,11988000,2691420,14679420
전남 신안군,지도작은도서관,0,16190000,2580200,18770200
전남 화순군,지혜샘어린이문고,500000,0,0,500000
전남 진도군,진도문화원 학고도서관,0,14377000,3623000,18000000
전남 여수시,책이랑나랑작은도서관,3700000,6000000,1200000,10900000
전남 순천시,책이랑툇마루작은도서관,2000000,0,0,2000000
전남 목포시,청개구리작은도서관,2500000,18985000,13236000,34721000
전남 완도군,청산지리문고,500000,0,0,500000
전남 나주시,청소년수련관북카페,0,0,0,0
전남 영암군,청용도서관,1500000,18000000,8000000,27500000
전남 목포시,초롱초롱작은도서관,1500000,19095000,14570000,35165000
전남 광양시,태금샬롬도서관,0,0,0,0
전남 광양시,태인 작은 도서관,4000000,6000000,1200000,11200000
전남 나주시,파랑새작은도서관,500000,0,0,500000
전남 순천시,파랑새작은도서관,2375000,6240000,6500000,15115000
전남 순천시,푸르미작은도서관,2375000,6240000,2020000,10635000
전남 영암군,푸른나무 작은도서관,1200000,0,0,1200000
전남 장흥군,푸른독서실,928570,0,0,928570
전남 목포시,푸른솔작은도서관,2000000,19055000,11132000,32187000
전남 여수시,푸른정원작은도서관(구 두란노서원문고),2300000,6000000,600000,8900000
전남 강진군,풀꽃문고,0,0,0,0
전남 순천시,풍덕금호작은도서관,1000000,6240000,2200000,9440000
전남 순천시,피오레작은도서관,2000000,6240000,2020000,10260000
전남 목포시,피터팬작은도서관,150000,18620000,12626000,31396000
전남 여수시,필립영어도서관,0,0,6000000,6000000
전남 광양시,필유사랑나눔도서관,0,0,0,0
전남 순천시,하날다래작은도서관,3075000,6240000,3000000,12315000
전남 곡성군,하늘나리 작은도서관,0,0,0,0
전남 목포시,하늘을나는도서관,3600000,0,8000000,11600000
전남 완도군,하리작은도서관,0,0,0,0
전남 신안군,하의작은도서관,0,16190000,3482540,19672540
전남 여수시,학마을 작은도서관,2600000,15400000,6000000,24000000
전남 여수시,한려작은도서관,4000000,7410000,4000000,15410000
전남 영암군,한마음문고,2500000,0,2600000,5100000
전남 여수시,한빛문고,1300000,3600000,2000000,6900000
전남 영암군,한울타리작은도서관,1000000,0,1000000,2000000
전남 담양군,한이직기념도서관,20000000,0,30000000,50000000
전남 화순군,한천하누리작은도서관,0,0,0,0
전남 여수시,함께하는 작은도서관,1300000,0,0,1300000
전남 해남군,해남다문화작은도서관,0,0,0,0
전남 여수시,해들누리작은도서관,1300000,0,0,1300000
전남 순천시,해룡성산도서관 ,2000000,7080000,1200000,10280000
전남 순천시,해룡소안작은도서관,1000000,7080000,1200000,9280000
전남 나주시,해맑음작은도서관,500000,0,0,500000
전남 화순군,해망마을도서관,1300900,755890,2556900,4613690
전남 함평군,해보작은도서관,1177400,0,19526680,20704080
전남 나주시,해오름작은도서관,500000,0,0,500000
전남 여수시,현천작은도서관(구 현천문고),3000000,6000000,4200000,13200000
전남 순천시,호반2차꿈꾸는작은도서관,2375000,6240000,1020000,9635000
전남 영광군,홍농작은도서관,9772300,10577060,10724880,31074240
전남 구례군,홍당무어린이도서관,0,0,500000,500000
전남 화순군,화순작은도서관,0,0,0,0
전남 화순군,화순중앙도서관,200000,0,0,200000
전남 해남군,황산면주민자치센터작은도서관,1728000,6400000,6911000,15039000
전남 장흥군,회진 청소년 문화의집,928570,0,0,928570
전남 무안군,훈민정음 작은도서관,3350000,0,1200000,4550000
전남 순천시,흑두루미작은도서관,2000000,6240000,2200000,10440000
전남 여수시,희망도서관 꿈이룸방,0,0,0,0
전남 여수시,힐스테이트 행복 작은도서관,10000000,0,0,10000000
전북 김제시,JG작은도서관,5000000,12000000,2300000,19300000
전북 전주시,간납대작은도서관,5000000,11400000,2400000,18800000
전북 정읍시,감골작은도서관,5000000,12000000,6000000,23000000
전북 전주시,개골개골도서관,2000000,42000000,20000000,64000000
전북 부안군,개암작은도서관,5000000,17276000,10709000,32985000
전북 전주시,건지산숲속작은도서관,5000000,16400000,8400000,29800000
전북 김제시,검산 작은도서관,5000000,13200000,2400000,20600000
전북 군산시,경암작은도서관,0,0,500000,500000
전북 완주군,경천애인작은도서관,4500000,1700000,4150000,10350000
전북 정읍시,고부작은도서관,5000000,12000000,6000000,23000000
전북 고창군,고수해마루작은도서관,6000000,6500000,5700000,18200000
전북 부안군,고인돌작은도서관,5000000,12424320,6248000,23672320
전북 전주시,곰솔나무 작은도서관 ,0,0,0,0
전북 전주시,광선문고,0,0,0,0
전북 김제시,교동골 작은도서관,5000000,15600000,2400000,23000000
전북 군산시,구세군 엘림문고,0,0,0,0
전북 군산시,구암작은도서관,9375000,29265050,16050000,54690050
전북 완주군,구이모악작은도서관,5000000,17000000,4150000,26150000
전북 전주시,글마당작은도서관,5000000,12000000,2400000,19400000
전북 익산시,글마루작은도서관,5000000,12900000,2400000,20300000
전북 고창군,글마루작은도서관,5000000,0,8400000,13400000
전북 남원시,금동꿈나무문고,1500000,0,0,1500000
전북 남원시,금동작은도서관,5000000,12000000,1200000,18200000
전북 전주시,금호작은도서관,5000000,15600000,2400000,23000000
전북 김제시,길보작은도서관,5000000,16429900,2400000,23829900
전북 익산시,깊은샘작은도서관,5300000,12900000,2400000,20600000
전북 정읍시,꽃들의둥지 문고,0,0,0,0
전북 남원시,꿈그린 작은도서관,2500000,0,200000,2700000
전북 익산시,꿈꾸는뜰 어린이도서관,5850000,39000000,23000000,67850000
전북 전주시,꿈나무도서관 ,6000000,4800000,3200000,14000000
전북 전주시,꿈나무문고,0,0,0,0
전북 전주시,꿈드리작은도서관,5000000,15600000,2400000,23000000
전북 익산시,꿈드림작은도서관,5000000,12000000,2400000,19400000
전북 전주시,꿈마을작은도서관 ,1200000,0,600000,1800000
전북 전주시,꿈밭장애인 작은도서관,5000000,12000000,2400000,19400000
전북 전주시,꿈이있는나무작은도서관,5000000,12000000,2400000,19400000
전북 익산시,꿈틀문고,0,0,0,0
전북 전주시,나래영상도서관,1000000,0,0,1000000
전북 군산시,나운작은도서관,9375000,37822590,16050000,63247590
전북 군산시,나포작은도서관,9375000,25566710,16050000,50991710
전북 남원시,남원독서문화원,2800000,0,4800000,7600000
전북 익산시,낭산작은도서관,5000000,11900000,2400000,19300000
전북 진안군,노계3동뜨란채 작은도서관,5000000,12000000,2400000,19400000
전북 남원시,노암마을문고,2000000,0,0,2000000
전북 군산시,노인종합복지관작은도서관,5000000,12000000,2400000,19400000
전북 군산시,늘빛문고,3000000,0,0,3000000
전북 진안군,능길마을 작은도서관,5000000,12000000,2400000,19400000
전북 임실군,다독다독 작은도서관,5000000,0,8400000,13400000
전북 완주군,대덕꿈도서관,2000000,0,2000000,4000000
전북 완주군,대명누리꿈작은도서관,1000000,0,200000,1200000
전북 고창군,대산큰별작은도서관,6000000,6500000,5700000,18200000
전북 전주시,덕진품애작은도서관,5000000,12000000,2400000,19400000
전북 남원시,도통동공립문고,2800000,10878480,0,13678480
전북 남원시,독우물 작은 도서관,5000000,12000000,2400000,19400000
전북 전주시,동네방네 작은도서관,0,0,0,0
전북 군산시,동문문고,200000,0,0,200000
전북 완주군,동부사립문고작은도서관,3000000,0,2000000,5000000
전북 익산시,동산작은도서관,5000000,12000000,2400000,19400000
전북 전주시,동신교회문고 ,2000000,0,0,2000000
전북 김제시,들꽃작은도서관,0,6000000,1200000,7200000
전북 전주시,루벤스 작은도서관,5000000,0,0,5000000
전북 진안군,마이성결작은도서관,2000000,0,0,2000000
전북 진안군,마이작은도서관,5000000,10800000,2400000,18200000
전북 전주시,마하나임 작은도서관,1000000,0,0,1000000
전북 남원시,만인문고,2000000,0,0,2000000
전북 전주시,맑은누리작은도서관,5000000,12000000,2400000,19400000
전북 남원시,메카센트럴 작은도서관,5000000,12000000,2400000,19400000
전북 군산시,명산사립작은도서관,3000000,0,0,3000000
전북 전주시,모롱지 작은도서관,5000000,23400000,8400000,36800000
전북 익산시,모현뜰작은도서관,5000000,12900000,2400000,20300000
전북 고창군,무장글샘작은도서관,6000000,6500000,7300000,19800000
전북 무주군,무주만나작은도서관,5000000,12000000,2400000,19400000
전북 완주군,무지개나라,3500000,0,2000000,5500000
전북 임실군,무지개빛 작은도서관,5000000,0,8400000,13400000
전북 군산시,무지개작은도서관,550000,0,0,550000
전북 전주시,무지개작은도서관,5000000,12000000,2400000,19400000
전북 정읍시,문화의집작은도서관,6000000,35000000,300000,41300000
전북 군산시,미룡작은도서관,9375000,36084870,16050000,61509870
전북 군산시,미성작은도서관,9375000,27818620,16050000,53243620
전북 전주시,미소뜰도서관 ,2000000,0,1600000,3600000
전북 무주군,반딧불 작은도서관,5000000,10800000,3600000,19400000
전북 익산시,반석문고,500000,0,0,500000
전북 익산시,배산작은도서관,5000000,12000000,2400000,19400000
전북 진안군,백운 흰구름 작은도서관,5000000,12000000,2400000,19400000
전북 고창군,버들눈도서관,3600000,0,1200000,4800000
전북 장수군,번암작은도서관,1500000,13821000,21020000,36341000
전북 익산시,벧엘 어린이 문고,360000,0,0,360000
전북 순창군,복흥문고,100000,0,0,100000
전북 익산시,봄나루작은도서관,5000000,12000000,2400000,19400000
전북 익산시,부송열린문고,500000,0,0,500000
전북 익산시,부송작은도서관,5000000,14994560,2400000,22394560
전북 정읍시,북면작은도서관,5000000,12000000,6000000,23000000
전북 남원시,빨간사과 작은도서관,5000000,12000000,2400000,19400000
전북 남원시,산내품안문고,2400000,8336000,0,10736000
전북 군산시,산단작은도서관,3383000,12450700,19000000,34833700
전북 장수군,산서문고,0,0,0,0
전북 익산시,삼성어린이작은도서관,5000000,12000000,2400000,19400000
전북 완주군,상관기찻길작은도서관,5000000,1700000,4150000,10850000
전북 정읍시,상동작은도서관,5000000,12000000,6000000,23000000
전북 김제시,새마을 작은 도서관,5000000,13200000,1200000,19400000
전북 남원시,새싹작은도서관,5000000,12000000,2400000,19400000
전북 정읍시,샛별사립문고,0,0,0,0
전북 전주시,서곡주공작은도서관,2400000,0,0,2400000
전북 군산시,서수작은도서관,5000000,5400000,2400000,12800000
전북 익산시,성북작은도서관,5000000,6188040,2400000,13588040
전북 군산시,성원문고,3000000,0,0,3000000
전북 전주시,성원솔로몬문고 ,2500000,0,0,2500000
전북 전주시,세광문고,0,0,0,0
전북 완주군,소양철쭉작은도서관,5000000,1700000,4150000,10850000
전북 군산시,솔내음,600000,0,0,600000
전북 남원시,송동 작은도서관,5000000,12000000,2400000,19400000
전북 전주시,송천뜨란채 도서관 ,6000000,25000000,5000000,36000000
전북 정읍시,수목토작은도서관,5000000,12000000,6000000,23000000
전북 군산시,수미작은도서관,5000000,12000000,2400000,19400000
전북 정읍시,수성작은도서관,5000000,12000000,6000000,23000000
전북 순창군,순창군 문화의집 작은도서관,5000000,0,15420000,20420000
전북 전주시,신일강변아파트 도서관 ,0,0,0,0
전북 김제시,신풍문고,3000000,0,0,3000000
전북 익산시,신황등 어린이문고,0,0,0,0
전북 정읍시,실버작은도서관,5000000,9500000,5500000,20000000
전북 군산시,아가페문고,0,0,0,0
전북 임실군,아낌없이주는나무 작은도서관,5000000,12000000,7400000,24400000
전북 전주시,아르펠리스 작은도서관,0,0,300000,300000
전북 익산시,아름다운 문고,500000,0,0,500000
전북 고창군,아산선운산작은도서관,6000000,6500000,5700000,18200000
전북 군산시,아이소리사립문고,0,0,0,0
전북 전주시,아이파크 도서관,0,0,1200000,1200000
전북 무주군,안성작은도서관,5000000,12000000,2400000,19400000
전북 임실군,안전작은도서관,3000000,0,10000000,13000000
전북 전주시,어깨동무 작은 도서관 ,6000000,0,1200000,7200000
전북 군산시,에덴의쉼터 작은도서관,1615500,0,784500,2400000
전북 전주시,에코르도서문고 ,4800000,8700000,3400000,16900000
전북 전주시,엘리트 작은도서관,600000,0,4200000,4800000
전북 익산시,여산교회문고,0,0,0,0
전북 전주시,열린점자 작은도서관,5000000,0,8400000,13400000
전북 전주시,예다음 작은도서관,5800000,0,0,5800000
전북 익산시,예문열린문고,700000,0,1000000,1700000
전북 익산시,예솔작은도서관,5000000,12900000,2400000,20300000
전북 군산시,예품사립작은도서관,3000000,0,0,3000000
전북 남원시,온누리작은도서관,2000000,0,0,2000000
전북 정읍시,옹달샘작은도서관,2400000,12000000,2800000,17200000
전북 전주시,옹달샘작은도서관 ,6500000,0,6731017,13231017
전북 익산시,왕궁작은도서관,5000000,12000000,2400000,19400000
전북 남원시,외평마을구심문고,2000000,0,0,2000000
전북 전주시,우미린 도서관,1070000,0,1330000,2400000
전북 전주시,우아문화의집작은도서관,5000000,12000000,2400000,19400000
전북 부안군,운호문고,500000,0,0,500000
전북 익산시,울림작은도서관,5000000,12000000,2400000,19400000
전북 군산시,월명작은도서관,9375000,63341960,16050000,88766960
전북 익산시,은총문고,720000,0,0,720000
전북 군산시,은파코아루아파트문고,0,0,0,0
전북 남원시,이그린작은도서관,5000000,12000000,1200000,18200000
전북 완주군,이서배꽃뜰작은도서관,5000000,17000000,4150000,26150000
전북 완주군,이서지역아동센터문고,3000000,0,3000000,6000000
전북 전주시,인후문화의집 작은도서관,5000000,12000000,2400000,19400000
전북 전주시,인후비젼 작은도서관,5000000,12000000,2400000,19400000
전북 전주시,자람터작은도서관,1080000,1200000,783000,3063000
전북 전주시,작은 행복도서관,1200000,0,300000,1500000
전북 장수군,장계문예복지관 작은도서관,2000000,20000000,7500000,29500000
전북 장수군,장수꿈나무사립문고,0,0,0,0
전북 장수군,장수청소년문화의집 작은도서관,20000000,48313000,7200000,75513000
전북 전주시,전주작은도서관,5000000,12000000,2400000,19400000
전북 완주군,정보화마을,1800000,0,2500000,4300000
전북 전주시,조은 작은도서관 ,50000,0,100000,150000
전북 군산시,조촌작은도서관,9375000,19300000,16050000,44725000
전북 전주시,좋은씨앗 작은도서관,3850000,0,0,3850000
전북 군산시,주성열린문고,0,0,0,0
전북 김제시,죽산작은도서관,5000000,12000000,2400000,19400000
전북 전주시,중심교회문고,0,0,0,0
전북 임실군,지사랑작은도서관,5000000,0,8400000,13400000
전북 익산시,지혜를 일구는 라인문고,0,0,0,0
전북 진안군,진안사랑작은도서관,2000000,0,0,2000000
전북 부안군,창북문고,2000000,0,1000000,3000000
전북 군산시,책마을 문고,500000,0,0,500000
전북 남원시,책사랑글사랑한알음문고,2800000,0,0,2800000
전북 전주시,책사랑작은도서관 ,3000000,0,120000,3120000
전북 익산시,책이있어좋은우남도서관,1202400,2400000,600000,4202400
전북 순창군,청소년센터 작은도서관,5000000,0,8400000,13400000
전북 전주시,청아 작은도서관 ,300000,200000,3000000,3500000
전북 전주시,청아나루 작은 도서관,5000000,12000000,2400000,19400000
전북 김제시,청하사랑작은도서관,5000000,10900000,2400000,18300000
전북 전주시,초록우산작은도서관,5000000,15600000,2400000,23000000
전북 완주군,초롱이문고,3000000,0,1500000,4500000
전북 정읍시,초산작은도서관,5000000,12000000,6000000,23000000
전북 임실군,충경작은도서관,3000000,0,0,3000000
전북 전주시,큰나루작은도서관,5000000,12000000,2400000,19400000
전북 전주시,팔복작은도서관,5000000,12000000,2400000,19400000
전북 전주시,평화꿈틀작은도서관,5000000,13200000,1200000,19400000
전북 전주시,평화동작은도서관,2000000,0,1000000,3000000
전북 임실군,필봉 작은도서관,5000000,12000000,2400000,19400000
전북 군산시,하늘정원작은도서관,0,0,0,0
전북 전주시,한길 작은도서관,200000,0,60000,260000
전북 군산시,한우리문고,240000,0,0,240000
전북 익산시,함열학교마을작은도서관 ,8195750,5717150,2400000,16312900
전북 고창군,항일역사도서관,1500000,0,2000000,3500000
전북 전주시,행복나눔작은도서관,5000000,12000000,2400000,19400000
전북 익산시,행복세상작은도서관,5000000,14815800,2418200,22234000
전북 전주시,호반꿈나래도서관,1000000,0,500000,1500000
전북 전주시,호성작은도서관,5000000,12000000,2400000,19400000
전북 전주시,호크마작은도서관,0,0,0,0
전북 남원시,혼불 작은도서관,5000000,6000000,2400000,13400000
전북 완주군,화산골작은도서관,4500000,1700000,4150000,10350000
전북 익산시,황등 작은도서관,1500000,0,0,1500000
전북 남원시,황죽작은도서관,5000000,12000000,2400000,19400000
전북 전주시,효사랑푸른꿈작은도서관,5000000,15600000,2400000,23000000
전북 남원시,휴먼시아 작은도서관,5000000,12000000,2400000,19400000
전북 전주시,휴먼시아아이린작은도서관,1200000,0,2400000,3600000
전북 군산시,흥남작은도서관,9375000,28386310,16050000,53811310
전북 전주시,희망나눔도서관,0,0,0,0
전북 김제시,희망남포작은도서관,5000000,12000000,5000000,22000000
전북 군산시,희망사립작은도서관,500000,0,100000,600000
제주 서귀포시,가시리새마을문고,1000000,4800000,4200000,10000000
제주 서귀포시,감산리 새마을문고,1200000,4800000,4000000,10000000
제주 제주시,강구리새마을작은도서관,0,0,700000,700000
제주 서귀포시,갯머리작은도서관,3304600,7200000,4495400,15000000
제주 제주시,고성1리새마을작은도서관,0,0,700000,700000
제주 제주시,광령1리새마을작은도서관,500000,2200000,2000000,4700000
제주 제주시,교래리새마을작은도서관,0,0,700000,700000
제주 제주시,귀덕3리새마을작은도서관,0,0,700000,700000
제주 제주시,금능꿈차롱작은도서관,4000000,7200000,3800000,15000000
제주 제주시,금악리새마을작은도서관,200000,2200000,1000000,3400000
제주 제주시,김녕리새마을작은도서관,99000,4800000,5101000,10000000
제주 제주시,꿈이 있는 작은도서관,1500000,0,0,1500000
제주 서귀포시,남원JC새마을문고,900000,10800000,300000,12000000
제주 제주시,납읍새마을작은도서관,700000,4800000,4500000,10000000
제주 제주시,노형꿈틀작은도서관,6000000,32000000,11200000,49200000
제주 제주시,노형부영2차새마을작은도서관,0,0,700000,700000
제주 제주시,달리작은도서관,600000,9500000,14000000,24100000
제주 제주시,대림리새마을작은도서관,0,0,700000,700000
제주 서귀포시,대평리새마을문고,1000000,0,1000000,2000000
제주 서귀포시,덕수새마을문고,800000,1000000,2056000,3856000
제주 제주시,도두1동새마을작은도서관,0,0,600000,600000
제주 제주시,도련1동새마을작은도서관,0,2200000,800000,3000000
제주 제주시,도련주공새마을작은도서관,0,0,600000,600000
제주 서귀포시,동광리새마을문고,2000000,6600000,6400000,15000000
제주 제주시,동려새마을작은도서관,0,0,600000,600000
제주 서귀포시,동홍1동새마을문고,0,0,0,0
제주 서귀포시,동홍3희망새마을문고,0,0,0,0
제주 서귀포시,동홍6새마을 문고,0,0,0,0
제주 서귀포시,동홍대림새마을문고,0,0,0,0
제주 서귀포시,동홍반석아르미문고,0,0,0,0
제주 제주시,동화새마을작은도서관,450000,4800000,4750000,10000000
제주 제주시,두맹이작은도서관,3200000,15600000,10300000,29100000
제주 제주시,두모리새마을작은도서관,0,0,700000,700000
제주 제주시,뜨란채새마을작은도서관,0,9600000,1850000,11450000
제주 제주시,명월리새마을작은도서관,0,2640000,2000000,4640000
제주 서귀포시,보목 꿈터 작은도서관,1930000,7656130,5413870,15000000
제주 제주시,복지새마을작은도서관,0,0,700000,700000
제주 제주시,봉개새마을작은도서관,2500000,5000000,2500000,10000000
제주 제주시,봉성새별작은도서관,3468380,8400000,3131620,15000000
제주 제주시,북촌리새마을작은도서관,0,0,600000,600000
제주 제주시,비양리새마을작은도서관,0,0,600000,600000
제주 서귀포시,사계리새마을문고,1800000,4800000,3600000,10200000
제주 제주시,사평새마을작은도서관,0,2200000,3924883,6124883
제주 서귀포시,산남새마을문고,0,0,0,0
제주 서귀포시,삼달리작은도서관,2400000,7200000,5400000,15000000
제주 제주시,상가리새마을작은도서관,0,0,600000,600000
제주 제주시,상명리새마을작은도서관,0,0,600000,600000
제주 서귀포시,상모1리 새마을문고,800000,4800000,5200000,10800000
제주 서귀포시,상모2리새마을문고,0,0,0,0
제주 서귀포시,상모3리새마을문고,400000,0,1500000,1900000
제주 서귀포시,상모서상동새마을문고,800000,0,3700000,4500000
제주 제주시,상승새마을작은도서관,0,0,400000,400000
제주 서귀포시,상창바람소리작은도서관,2687240,5400000,6912760,15000000
제주 제주시,새삶청소년공부방,2000000,4800000,3200000,10000000
제주 서귀포시,색달새마을문고,0,0,0,0
제주 제주시,서광리새마을작은도서관,0,0,700000,700000
제주 서귀포시,서광서리새마을문고,2000000,0,2000000,4000000
제주 서귀포시,서광이 비치는(서광동리) 새마을 문고,1500000,0,5486820,6986820
제주 제주시,서귀포JC새마을문고,0,0,0,0
제주 제주시,선흘1리새마을작은도서관,0,0,600000,600000
제주 제주시,설문대어린이도서관,2000000,18000000,5000000,25000000
제주 서귀포시,성읍2리 새마을문고,600000,0,1000000,1600000
제주 제주시,성화새마을작은도서관,1800000,4800000,3400000,10000000
제주 서귀포시,세화1리새마을문고,1000000,4800000,4200000,10000000
제주 제주시,수산리새마을작은도서관,0,2200000,800000,3000000
제주 서귀포시,수산초새마을문고,0,0,0,0
제주 서귀포시,신례2리 새마을문고,300000,4800000,4900000,10000000
제주 제주시,신천지새마을작은도서관,0,0,700000,700000
제주 제주시,신촌리새마을작은도서관,0,2200000,26000000,28200000
제주 제주시,신흥리새마을작은도서관,0,0,600000,600000
제주 서귀포시,아담한새마을문고,0,0,0,0
제주 제주시,아라스위첸새마을작은도서관,0,0,600000,600000
제주 제주시,어린이도서관꿈틀책방,0,0,0,0
제주 제주시,연동대림새마을작은도서관,0,0,700000,700000
제주 제주시,연미새마을작은도서관,0,0,700000,700000
제주 서귀포시,열운이작은도서관,6000000,6000000,3000000,15000000
제주 제주시,염광새마을작은도서관,0,0,700000,700000
제주 서귀포시,예래새마을문고,0,0,0,0
제주 제주시,예원새마을작은도서관,0,0,700000,700000
제주 서귀포시,예촌작은도서관,3500000,6000000,5500000,15000000
제주 제주시,오도새마을작은도서관,0,2200000,800000,3000000
제주 제주시,오라공설새마을작은도서관,0,2200000,900000,3100000
제주 서귀포시,오석새마을문고,0,0,0,0
제주 제주시,옹포리새마을작은도서관,0,4800000,5200000,10000000
제주 제주시,와산매실작은도서관,2961000,5461000,6578000,15000000
제주 제주시,외도1차부영새마을작은도서관,0,2200000,1000000,3200000
제주 제주시,외도2차부영새마을작은도서관,200000,2200000,1080000,3480000
제주 제주시,외도아름새마을작은도서관,0,0,50000,50000
제주 제주시,용강새마을작은도서관,0,0,600000,600000
제주 제주시,용당리새마을작은도서관,0,0,600000,600000
제주 서귀포시,용흥새마을문고,0,0,0,0
제주 서귀포시,웃토산작은도서관,6000000,6000000,3000000,15000000
제주 제주시,원당작은도서관,2000000,7200000,5800000,15000000
제주 제주시,원앙새마을작은도서관,0,2200000,950000,3150000
제주 제주시,월령리새마을작은도서관,0,0,800000,800000
제주 제주시,월림새마을작은도서관,0,0,0,0
제주 제주시,월정리새마을작은도서관,0,0,650000,650000
제주 제주시,월평새마을작은도서관,0,0,700000,700000
제주 서귀포시,위미1리 새마을문고,600000,0,1000000,1600000
제주 서귀포시,위미2리새마을문고,1124000,0,1200000,2324000
제주 제주시,유수암청소년공부방,1920000,4800000,3280000,10000000
제주 제주시,으뜸새마을작은도서관,700000,0,0,700000
제주 서귀포시,의귀리 새마을 문고,1522230,4800000,3677770,10000000
제주 제주시,이도1동새마을작은도서관,300000,2200000,500000,3000000
제주 제주시,이도쉐마작은도서관,2000000,0,1000000,3000000
제주 제주시,이도주공새마을작은도서관,0,0,700000,700000
제주 제주시,일도대림새마을작은도서관,0,0,700000,700000
제주 제주시,일도새마을작은도서관,0,2200000,800000,3000000
제주 제주시,일도우성새마을작은도서관,0,0,650000,650000
제주 제주시,장원월드컵아파트새마을작은도서관,120000,0,777420,897420
제주 제주시,장전리새마을작은도서관,0,0,25900000,25900000
제주 제주시,정든새마을작은도서관,0,2200000,800000,3000000
제주 제주시,제방사새마을작은도서관,0,0,400000,400000
제주 제주시,제주서부방음도서관,15000000,55000000,30000000,100000000
제주 제주시,제주스카우트새마을작은도서관,394100,2200000,1045900,3640000
제주 제주시,조수1리새마을작은도서관,0,2200000,800000,3000000
제주 제주시,조천리새마을작은도서관,470000,0,3430000,3900000
제주 제주시,종달리새마을작은도서관,600000,2200000,800000,3600000
제주 서귀포시,중앙꿈쟁이작은도서관,1477700,25528050,22994250,50000000
제주 제주시,참꽃 작은도서관,3814880,6600000,4585120,15000000
제주 서귀포시,창천리 새마을문고,0,0,0,0
제주 제주시,청수리새마을작은도서관,0,0,800000,800000
제주 제주시,청풍작은도서관,0,800000,1800000,2600000
제주 서귀포시,태흥1리새마을문고,800000,0,1200000,2000000
제주 서귀포시,태흥2리새마을문고,1000000,0,1000000,2000000
제주 제주시,특전사새마을작은도서관,400000,0,0,400000
제주 제주시,판포리새마을작은도서관,0,0,600000,600000
제주 제주시,푸른열매작은도서관,4700000,7200000,3100000,15000000
제주 서귀포시,필승새마을문고,0,0,0,0
제주 제주시,하가리새마을작은도서관,0,2200000,800000,3000000
제주 제주시,하귀1리새마을작은도서관,0,0,700000,700000
제주 제주시,하귀휴먼시아1단지새마을작은도서관,0,0,700000,700000
제주 제주시,하늘나무도서관,2000000,0,8000000,10000000
제주 제주시,하도리새마을작은도서관,0,0,600000,600000
제주 서귀포시,하례1리새마을문고,1000000,0,7032000,8032000
제주 서귀포시,하모2리새마을문고,600000,0,1500000,2100000
제주 서귀포시,하모3리새마을문고,1000000,0,2500000,3500000
제주 서귀포시,하원애향새마을문고,0,0,0,0
제주 서귀포시,하효새마을문고,0,0,0,0
제주 서귀포시,한남리 새마을 문고,400000,0,1000000,1400000
제주 서귀포시,한라새마을문고,0,0,0,0
제주 제주시,한수리새마을작은도서관,0,0,600000,600000
제주 서귀포시,한우리독서문화원 문고,0,0,0,0
제주 제주시,한일베라체새마을작은도서관,500000,0,200000,700000
제주 제주시,함덕리새마을작은도서관,3783900,16035000,1486815,21305715
제주 제주시,항운노조새마을작은도서관,0,0,400000,400000
제주 제주시,해안새마을작은도서관,350000,0,250000,600000
제주 제주시,해오름새마을작은도서관,0,0,850000,850000
제주 제주시,행복나눔 작은도서관,3000000,8000000,1500000,12500000
제주 제주시,혜성무지개새마을작은도서관,0,2200000,800000,3000000
제주 서귀포시,호근새마을문고,0,0,0,0
제주 제주시,홍익작은도서관,3000000,6000000,6000000,15000000
제주 제주시,화북1단지새마을작은도서관,800000,0,500000,1300000
제주 제주시,화북주공열린새마을작은도서관,1297690,4980000,4440120,10717810
충남 아산시,가족도서실(사랑방 작은도서관),198180,0,6307700,6505880
충남 보령시,고대도도서관,4000000,0,1200000,5200000
충남 당진시,고대웃음꽃 작은도서관,12000000,31200000,2530000,45730000
충남 천안시,고맙습니다성정1동작은도서관,4301400,12147808,7495344,23944552
충남 당진시,고맙습니다원당꿈초롱 작은도서관,12000000,24400000,2530000,38930000
충남 서산시,고북 작은도서관,5000000,25621000,0,30621000
충남 천안시,곰돌이작은도서관,2500000,0,500000,3000000
충남 보령시,공립 오천작은도서관,5000000,19000000,3000000,27000000
충남 공주시,공주시옥룡동작은도서관,20000000,6000000,3000000,29000000
충남 천안시,광덕 작은도서관,4314500,11887938,1801576,18004014
충남 보령시,광명샤인빌작은도서관,2900000,0,1100000,4000000
충남 논산시,광석(빛돌)작은도서관,5000000,0,0,5000000
충남 서산시,구세군인권 작은도서관,3000000,0,500000,3500000
충남 금산군,군북면 작은도서관,4000000,0,12000000,16000000
충남 홍성군,글마루작은도서관,5000000,14235000,15000000,34235000
충남 서산시,글사랑작은도서관,3300000,0,1000000,4300000
충남 금산군,금산작은도서관,4000000,16500000,3900000,24400000
충남 보령시,꿈꾸는숲작은도서관,3200000,0,800000,4000000
충남 천안시,꿈나래작은도서관,3500000,0,3100000,6600000
충남 논산시,꿈나무작은도서관,3206370,0,800000,4006370
충남 당진시,꿈의 도서관,50,0,360,410
충남 당진시,꿈자람터 작은도서관,200000,4800000,500000,5500000
충남 아산시,꿈자리작은도서관,0,0,0,0
충남 아산시,꿈터 작은도서관,0,0,3960000,3960000
충남 청양군,남양생명나무 작은도서관,1700000,0,4300000,6000000
충남 금산군,남일면 작은도서관,4000000,0,12000000,16000000
충남 천안시,남천안교회 어린이도서관,2400000,0,1200000,3600000
충남 논산시,노서서재,3000000,0,3000000,6000000
충남 논산시,노성교회작은도서관,3200000,0,1000000,4200000
충남 논산시,논산시 청소년수련관 작은도서관,5000000,0,3000000,8000000
충남 논산시,논산제일성결교회 작은도서관,3000000,0,0,3000000
충남 아산시,누리재도서관(휴먼시아8차),3000000,2400000,1000000,6400000
충남 천안시,느티나무마을도서관,720000,0,2400000,3120000
충남 서산시,늘푸른 작은도서관,3000000,12000000,1000000,16000000
충남 천안시,늘푸른문고,1000000,0,0,1000000
충남 당진시,다니엘문고,1000000,0,5000000,6000000
충남 천안시,다니엘문고,200000,0,0,200000
충남 천안시,대광작은도서관,1000000,0,2000000,3000000
충남 보령시,대천신흥작은도서관,0,0,1200000,1200000
충남 보령시,대천애육원작은도서관,3033000,0,967000,4000000
충남 보령시,대천작은도서관,2000000,0,1000000,3000000
충남 보령시,대천항작은도서관,0,0,0,0
충남 청양군,대치면 작은도서관,0,0,0,0
충남 당진시,대호지책나래 작은도서관,12000000,24000000,2530000,38530000
충남 예산군,덕산작은도서관,30000000,6256000,71660000,107916000
충남 공주시,독서학교논술문화 작은도서관,3200000,3000000,8800000,15000000
충남 보령시,동대천작은도서관,3194460,800000,0,3994460
충남 서산시,동문동아더프라임 작은도서관,3300000,0,0,3300000
충남 천안시,동일하이빌문고,1674140,4800000,1487200,7961340
충남 아산시,동일하이빌아파트도서관,3000000,3492000,1113700,7605700
충남 논산시,두란노도서관,2406850,0,8898210,11305060
충남 계룡시,두란노독서문화원,0,0,0,0
충남 아산시,드림하이 작은도서관,4000000,0,1900000,5900000
충남 보령시,들꽃마당김도희작은도서관,1500000,0,600000,2100000
충남 천안시,들꽃언덕 작은도서관,1500000,0,13200000,14700000
충남 천안시,류관순서원,1000000,0,1000000,2000000
충남 천안시,마음앓이 생각넘어 작은도서관,500000,0,0,500000
충남 아산시,모아미래도아파트 도서관,0,0,0,0
충남 아산시,모종e.편한작은도서관,0,1440000,0,1440000
충남 아산시,모종한성2차 작은도서관,3000540,0,1150000,4150540
충남 아산시,모종한성필1차문고,3000000,1440000,1000000,5440000
충남 청양군,목면 작은도서관,2000000,4000000,500000,6500000
충남 천안시,목천작은도서관,4340500,11872348,1267230,17480078
충남 보령시,무창포작은도서관,2570000,0,1430000,4000000
충남 서천군,문산마을도서관,1600000,0,0,1600000
충남 천안시,문성동 작은도서관,4378300,11943628,5225452,21547380
충남 서산시,미문 작은도서관,3300000,0,0,3300000
충남 보령시,미산성실도서관,3500000,0,500000,4000000
충남 공주시,반포면작은도서관,39000000,0,500000,39500000
충남 아산시,배방 중앙1차 작은도서관,3000000,0,1000000,4000000
충남 아산시,배방롯데캐슬문고,3000000,3251790,1700000,7951790
충남 아산시,배방자이1차아파트문고,3200000,1470000,2535000,7205000
충남 아산시,배방자이2차아파트작은도서관,3000000,0,3400000,6400000
충남 아산시,배방한성필 도서관,0,480000,0,480000
충남 천안시,백석벽산블루밍2차한들공부방,0,0,0,0
충남 보령시,보령작은도서관,0,0,0,0
충남 보령시,보령햇살작은도서관,1750000,0,2250000,4000000
충남 천안시,보물섬도서관,100000,300000,100000,500000
충남 서산시,부석 작은도서관,5000000,24856000,0,29856000
충남 부여군,부여군청소년수련원문화의집,4000000,0,0,4000000
충남 천안시,북면바로내 작은도서관,5936800,6953132,11027260,23917192
충남 예산군,불꽃도서관,3000000,0,3200000,6200000
충남 천안시,불당아이파크사립 작은도서관,2000000,0,1800000,3800000
충남 서산시,비발디 작은도서관,3300000,6000000,1000000,10300000
충남 청양군,비봉면 작은도서관,0,0,0,0
충남 보령시,빛뜰작은도서관,3123700,0,876300,4000000
충남 보령시,사과나무작은도서관,0,0,200000,200000
충남 태안군,사랑의도서관,0,18000000,5000000,23000000
충남 아산시,삼부르네상스 도서관,700000,350000,0,1050000
충남 아산시,상록도서관(꿈나무도서관),3000000,3600000,2400000,9000000
충남 당진시,상록수 작은도서관,0,3600000,1200000,4800000
충남 금산군,상리 주공 2단지 작은도서관,0,0,0,0
충남 논산시,상월어린이도서관,3200000,0,0,3200000
충남 논산시,상월주민자치도서관,10000000,0,0,10000000
충남 아산시,새마을작은도서관,0,0,0,0
충남 아산시,새생활도서관,3500000,0,1200000,4700000
충남 보령시,새소리작은도서관,1000000,0,1000000,2000000
충남 천안시,새소망작은도서관,1000000,1200000,300000,2500000
충남 아산시,새솔마을(중앙3차) 작은도서관,0,0,0,0
충남 아산시,생각뿌리작은도서관,0,0,0,0
충남 아산시,서들광문 작은도서관,0,0,1000000,1000000
충남 천안시,서로사랑문고,0,0,0,0
충남 서산시,서산롯데캐슬 작은도서관,3300000,12000000,1000000,16300000
충남 서산시,서산문화원 작은도서관,3300000,0,0,3300000
충남 서산시,서산시다문화 작은도서관,3000000,18000000,0,21000000
충남 당진시,서정마을문고,0,0,0,0
충남 서천군,서천문고,0,0,1000000,1000000
충남 아산시,서해그랑블2단지문고실,3600000,400000,3600000,7600000
충남 당진시,석문생각나무 작은도서관,12000000,31200000,2530000,45730000
충남 서천군,선도래 작은도서관,16000000,0,0,16000000
충남 천안시,성남면 작은도서관,4346700,11943628,1337076,17627404
충남 천안시,성정2동 작은도서관,4407100,11943628,4444122,20794850
충남 보령시,성주작은도서관,3000000,0,1000000,4000000
충남 천안시,성환읍다문화 작은도서관,5111900,11870428,6781076,23763404
충남 천안시,성환제일작은도서관,0,0,0,0
충남 논산시,소망작은도서관,50000,0,200000,250000
충남 당진시,송산개미 작은도서관,12000000,31200000,2530000,45730000
충남 당진시,송악샘터 작은도서관,12000000,15000000,2530000,29530000
충남 당진시,송악해나루 작은도서관,12000000,24000000,2530000,38530000
충남 서산시,수림작은도서관,3300000,6000000,1000000,10300000
충남 당진시,순성반딧불이 작은도서관,12000000,31200000,2530000,45730000
충남 서산시,쉴만한물가작은도서관,3300000,0,0,3300000
충남 서천군,시선도서관,4000000,0,1000000,5000000
충남 홍성군,신동아작은도서관,4000000,0,0,4000000
충남 천안시,신방동한라도서관,3000000,0,3000000,6000000
충남 천안시,신안동 작은도서관,4324400,11207548,6200236,21732184
충남 아산시,신정성모 작은도서관,3000000,0,1000000,4000000
충남 당진시,신평거산 작은도서관,12000000,24000000,2530000,38530000
충남 당진시,신평청소년 작은도서관,12000000,31200000,2530000,45730000
충남 천안시,쌍용자이아파트 작은도서관,1137520,0,1262480,2400000
충남 당진시,아름다운 작은도서관,7000000,0,2000000,9000000
충남 논산시,아름다운도서관,4000000,0,0,4000000
충남 아산시,아산 아이파크 아파트 문고실,4400000,6000000,4600000,15000000
충남 아산시,아산권곡청솔아파트도서관,3000000,3600000,2358400,8958400
충남 아산시,아산글사랑문고,0,0,0,0
충남 아산시,아산모종한성필하우스 문고,0,0,0,0
충남 아산시,아산배방푸르지오문고,3000000,0,1000000,4000000
충남 아산시,아산포스코더？레이크사이드 문고,4477720,3600000,0,8077720
충남 아산시,아산푸르지오 문고,0,0,0,0
충남 논산시,야화1리작은도서관,0,0,0,0
충남 논산시,양촌제일도서관,3200000,0,800000,4000000
충남 아산시,어진고을문고,0,0,200000,200000
충남 천안시,업성꿈샘작은도서관,400000,0,200000,600000
충남 서천군,여우네도서관,1200000,0,3600000,4800000
충남 아산시,연화마을 칸6단지아파트 작은도서관,0,0,0,0
충남 천안시,열린작은도서관,1200000,9600000,6000000,16800000
충남 금산군,열린작은도서관,0,0,0,0
충남 서천군,영광문고,0,0,1000000,1000000
충남 아산시,예꿈어린이도서관,0,0,0,0
충남 서산시,예닮작은도서관,0,0,0,0
충남 서산시,예천주공1단지 작은도서관,3300000,0,0,3300000
충남 서산시,예천한성필 작은도서관,3300000,0,55000000,58300000
충남 태안군,온누리작은도서관,3000000,0,2000000,5000000
충남 아산시,온지중앙 작은도서관,0,0,0,0
충남 아산시,옹달샘도서관,0,0,0,0
충남 아산시,와이시티 작은도서관,5400000,0,1000000,6400000
충남 천안시,용암문고,0,0,0,0
충남 아산시,용연마을 2차 작은도서관,0,1440000,600000,2040000
충남 아산시,용화마을신도브래뉴아파트,3000000,2400000,1000000,6400000
충남 아산시,우리들문고,3000000,0,1000000,4000000
충남 보령시,웃음소리작은도서관,2200000,0,1800000,4000000
충남 천안시,원성2동 작은도서관,4318000,11785808,21300777,37404585
충남 서천군,월남마을도서관,0,0,1000000,1000000
충남 서천군,월남문고,0,0,1000000,1000000
충남 서천군,월포교회사랑도서관,0,0,2000000,2000000
충남 서천군,은평작은도서관,0,0,1000000,1000000
충남 서천군,은혜교회문고,0,0,1000000,1000000
충남 예산군,은혜도서관,3200000,0,1200000,4400000
충남 서산시,음암책읽는 마을작은도서관,3300000,0,0,3300000
충남 서산시,읍내현대아파트 작은도서관,3300000,7200000,1000000,11500000
충남 천안시,이안더샌트럴아파트작은도서관,8000000,7200000,150000,15350000
충남 아산시,이화작은도서관,0,0,0,0
충남 아산시,인주꿈꾸는팽나무 작은도서관,3000000,3600000,6000000,12600000
충남 서산시,인지 작은도서관,5000000,25158000,0,30158000
충남 천안시,일봉동 작은도서관,4380800,12147678,4466812,20995290
충남 천안시,입장면 작은도서관,4383300,11958648,4382482,20724430
충남 천안시,작은나눔도서관,1000000,5000000,3000000,9000000
충남 천안시,작은불씨도서관,840000,1200000,1200000,3240000
충남 아산시,장수마을꿈꾸는 도서관,3600000,0,3551000,7151000
충남 부여군,장암공부방,2200000,0,1800000,4000000
충남 아산시,장재마을 작은도서관,4500000,3600000,1200000,9300000
충남 청양군,장평면 작은도서관,0,0,0,0
충남 금산군,제원작은도서관,4000000,0,12000000,16000000
충남 부여군,좋은도서관,150000,0,2000000,2150000
충남 천안시,좋은열매작은도서관,1000000,0,1000000,2000000
충남 서산시,좋은친구작은도서관,0,0,0,0
충남 서산시,중앙 작은도서관,3300000,0,0,3300000
충남 천안시,중앙동 작은도서관,4330100,11928608,5138276,21396984
충남 아산시,중앙하이츠1차@작은도서관,0,0,0,0
충남 천안시,직산읍 작은도서관,4330600,11943628,2113522,18387750
충남 태안군,진흥작은도서관,3000000,0,2000000,5000000
충남 공주시,착한작은도석관,3200000,0,4000000,7200000
충남 당진시,채운공원휴먼빌 작은도서관,0,0,0,0
충남 논산시,천동교회작은도서관,8000000,0,2000000,10000000
충남 천안시,천안박물관 작은 도서관,4456400,12154048,4941422,21551870
충남 천안시,천안별찌작은도서관,2000000,2800000,5200000,10000000
충남 천안시,천안주민문고,0,0,0,0
충남 청양군,청남꿈꾸는 작은도서관,150,0,0,150
충남 천안시,청수부영작은도서관,0,0,100000,100000
충남 공주시,청향원 작은도서관,3200000,0,12800000,16000000
충남 예산군,초록꿈작은도서관,0,0,1000000,1000000
충남 천안시,축구센타작은도서관,4328600,12127208,3954776,20410584
충남 천안시,친구문고,1500000,3000000,1500000,6000000
충남 아산시,칸4단지 작은도서관,0,0,1000000,1000000
충남 아산시,코아루에듀파크아파트도서관,4000000,9600000,5000000,18600000
충남 아산시,키움작은도서관(구.초원어린이 도서관),4000000,0,6000000,10000000
충남 아산시,탕정작은도서관,3600000,612000,2188000,6400000
충남 태안군,태안주공작은도서관,3000000,2400000,3400000,8800000
충남 아산시,텃밭인문학 작은도서관(구. 우당인문학 작은도서관),0,0,15000000,15000000
충남 천안시,파크밸리 작은도서관,0,0,0,0
충남 서천군,판교 도토리 작은도서관,1600000,0,0,1600000
충남 천안시,푸른나무숲도서관,1000000,6000000,1400000,8400000
충남 천안시,푸름꿈도서관,0,0,0,0
충남 천안시,풍세면 작은도서관,4349100,11943628,3203076,19495804
충남 논산시,하늘샘마을문고,2000000,0,1200000,3200000
충남 천안시,하늘샘어린이영어전문도서,600000,1200000,200000,2000000
충남 천안시,하늘정원교회 작은도서관,1000000,0,2000000,3000000
충남 아산시,한라비발디아파트도서관,80000,0,0,80000
충남 논산시,한빛도서관,0,0,0,0
충남 천안시,한빛장애인작은도서관,0,0,0,0
충남 보령시,한성필하우스작은도서관,0,0,0,0
충남 아산시,한우리독서문화원,500000,0,0,500000
충남 아산시,해늘도서관(용연마을휴먼시아1단지아파트도서관),0,0,0,0
충남 아산시,해비타트문고,500000,0,0,500000
충남 아산시,행복한도서관,0,0,0,0
충남 아산시,행복한무지개 작은도서관,3000000,17464000,3134500,23598500
충남 서산시,현진에버빌 작은도서관,3300000,0,1000000,4300000
충남 서산시,화목한작은도서관,0,0,5000000,5000000
충남 청양군,화성책카페,1600000,4800000,2400000,8800000
충남 논산시,황화정작은도서관,0,0,0,0
충남 보령시,효나눔작은도서관,800000,0,3200000,4000000
충남 보령시,희망꿈작은도서관,1500000,0,2500000,4000000
충남 금산군,희망도서관,0,0,0,0
충북 청주시,NGO도서관어울림,400000,0,1000000,1400000
충북 청주시,가경e편한세상문고,534450,1200000,300000,2034450
충북 청주시,가경선광로즈웰A주민도서관,0,0,343000,343000
충북 청주시,가경한라비발디아파트도서관,0,0,0,0
충북 청주시,가로수마을작은도서관,600000,0,1200000,1800000
충북 영동군,갈마루작은도서관,2000000,0,1200000,3200000
충북 괴산군,감나무작은도서관,3000000,0,0,3000000
충북 괴산군,감물면새마을문고,2000000,0,0,2000000
충북 증평군,고맙습니다 도담도담작은도서관,2500000,4800000,960000,8260000
충북 괴산군,괴산읍 새마울문고,0,0,0,0
충북 영동군,구세군 양강도서관,0,0,0,0
충북 청주시,구세군금천도서관,0,0,0,0
충북 옥천군,구세군옥천도서관,0,0,500000,500000
충북 영동군,궁촌작은도서관,200000,0,200000,400000
충북 청주시,글마루작은도서관,2400000,15540000,2400000,20340000
충북 청주시,금호어울림도서관,0,6000000,3400000,9400000
충북 청주시,금호예다움도서관,6000000,14000000,3400000,23400000
충북 청주시,꿈이 있는 도서관,0,0,0,0
충북 영동군,꿈이자라는문고,300000,0,200000,500000
충북 청주시,꿈키움작은도서관,874250,1200000,925340,2999590
충북 청주시,남광하우스토리작은도서관,4800000,10800000,0,15600000
충북 청주시,남청주나눔도서관,1500000,0,2000000,3500000
충북 진천군,남해오네뜨도서관,0,0,0,0
충북 제천시,남현동새마을작은도서관,0,0,0,0
충북 청주시,내수도서관,10154000,5400000,2400000,17954000
충북 제천시,내토시장새마을작은도서관,0,0,0,0
충북 청주시,"너,나, 우리도서관",100000,0,800000,900000
충북 제천시,누리작은도서관,2000000,0,1500000,3500000
충북 충주시,늘푸른문고,0,0,3600000,3600000
충북 증평군,늘푸른작은도서관,0,0,0,0
충북 청주시,다니엘문고,3000000,0,2400000,5400000
충북 증평군,다솔도서관,0,0,0,0
충북 제천시,당곡문고,0,0,0,0
충북 음성군,대명도서관,0,0,0,0
충북 음성군,대소문고,1000000,0,2400000,3400000
충북 청주시,대청작은도서관,2500000,0,0,2500000
충북 진천군,덕산새마을구심문고,1500000,16680000,3820000,22000000
충북 청주시,덕일아파트 작은도서관,500000,0,0,500000
충북 음성군,덕정새마을문고,0,0,0,0
충북 증평군,도안문고,2500000,4800000,0,7300000
충북 음성군,도토리숲 작은도서관,5000000,0,5000000,10000000
충북 청주시,두꺼비도서관,5000000,4800000,3000000,12800000
충북 청주시,두꺼비생태도서관,1000000,5400000,1000000,7400000
충북 청주시,드림교회작은도서관,1000000,1000000,1000000,3000000
충북 청주시,드림작은도서관,0,0,0,0
충북 제천시,들빛도서관,750000,0,250000,1000000
충북 청주시,디사이플스 북카페,1200000,1000000,2000000,4200000
충북 제천시,라온도서관,2000000,0,1000000,3000000
충북 영동군,리즈영어작은도서관,300000,6000000,700000,7000000
충북 충주시,맥타가트도서관,5000000,0,5000000,10000000
충북 청주시,맹꽁이생태도서관,1000000,7200000,1000000,9200000
충북 충주시,명성황후 도서관,3000000,0,500000,3500000
충북 괴산군,목도중앙열린문고,3000000,0,0,3000000
충북 충주시,목행나루작은도서관,6500000,20000000,11333330,37833330
충북 청주시,무지개도서관,9600000,287023000,92764000,389387000
충북 영동군,묵정마을도서관,0,0,0,0
충북 괴산군,문광면새마을문고,0,0,0,0
충북 진천군,문상문고,600000,0,0,600000
충북 제천시,물댄동산 도서관,2000000,0,1500000,3500000
충북 제천시,미당문고,0,0,0,0
충북 청주시,민들레,0,18000000,1000000,19000000
충북 청주시,발산문고,0,0,0,0
충북 청주시,밝은도서관,500000,0,500000,1000000
충북 옥천군,배바우 작은도서관,7500000,34800000,44000000,86300000
충북 보은군,뱃들작은도서관,11332110,0,1635300,12967410
충북 보은군,보은구심문고작은도서관,2500000,0,0,2500000
충북 청주시,봉명i`park 문고,1200000,0,500000,1700000
충북 청주시,봉명작은도서관,7000000,17940000,11044970,35984970
충북 충주시,봉숭아꽃작은도서관,6500000,20000000,11333330,37833330
충북 청주시,분평동작은마을도서관,0,0,0,0
충북 괴산군,불정면새마을문고,0,0,0,0
충북 청주시,비하계룡리슈빌2차@문고실,3600000,0,0,3600000
충북 청주시,쁘레네작은도서관(복대),3000000,8400000,15600000,27000000
충북 청주시,쁘레네작은도서관(용암),3000000,480000,14560000,18040000
충북 충주시,사과나무 작은도서관,1200000,0,0,1200000
충북 충주시,사과나무작은도서관,6500000,20000000,11333330,37833330
충북 음성군,사랑나눔도서관,500000,0,0,500000
충북 진천군,사랑나눔문고,600000,0,0,600000
충북 청주시,사랑의도서관,0,0,0,0
충북 청주시,사랑의문고,100000,0,200000,300000
충북 괴산군,사리면새마을문고,0,0,0,0
충북 증평군,사평문고,2000000,0,50000,2050000
충북 제천시,사회단체새마을문고,0,0,0,0
충북 청주시,산남계룡리슈빌아파트 도서관,1200000,1200000,1200000,3600000
충북 청주시,산남부영아파트도서관,2000000,0,1600000,3600000
충북 청주시,산남푸르지오도서관,1800000,1200000,8692616,11692616
충북 청주시,산성작은도서관,3800000,0,0,3800000
충북 제천시,산으실문고,500000,0,0,500000
충북 진천군,산호종합교육도서관,3100000,0,500000,3600000
충북 충주시,삼성새마을문고,2000000,7200000,3000000,12200000
충북 진천군,삼진문고(작은도서관),3100000,0,0,3100000
충북 청주시,상상다락방,2000000,10000000,0,12000000
충북 청주시,새로운 영어 도서관,0,0,0,0
충북 청주시,새소망작은도서관,2000000,0,300000,2300000
충북 청주시,새자연작은도서관,0,0,0,0
충북 청주시,생각의숲도서관,400000,0,1600000,2000000
충북 음성군,생극주민자치센터문고,0,0,0,0
충북 충주시,선교도서관,3000000,6000000,240000,9240000
충북 충주시,성산베리타스도서관,5000000,0,6000000,11000000
충북 청주시,성화5단지도서관 파레트,12000000,1200000,20000000,33200000
충북 청주시,성화꿈터작은도서관,0,0,0,0
충북 청주시,성화청개구리도서관,0,1800000,400000,2200000
충북 음성군,소망어린이문고,0,0,0,0
충북 청주시,소망작은도서관,3000000,0,0,3000000
충북 괴산군,소수면새마을문고,3000000,0,0,3000000
충북 청주시,솔로몬문고,0,0,0,0
충북 청주시,수곡작은도서관,0,0,0,0
충북 충주시,수안보작은도서관,6500000,20000000,11333330,37833330
충북 청주시,숨박꼭질도서관,120,0,0,120
충북 충주시,숲속작은도서관,0,0,0,0
충북 청주시,쉴만한물가,300000,0,300000,600000
충북 청주시,신나는독서학교(전 가경독서학교),500000,0,1200000,1700000
충북 제천시,신백동새마을작은도서관,0,0,0,0
충북 청주시,신영지웰시티1차북카페,0,0,6288060,6288060
충북 청주시,신영지웰홈스도서관,1000000,2080000,0,3080000
충북 진천군,신정주공 문고,0,0,0,0
충북 영동군,심천구세군문고,0,0,0,0
충북 청주시,쌍샘생태자연작은도서관,3600000,0,2400000,6000000
충북 청주시,쌍용규장각도서관,3992030,0,3538470,7530500
충북 청주시,쌍용예가작은도서관,0,0,900000,900000
충북 청주시,썬큰도서관(청주현진에버빌아파트),1200000,2400000,900000,4500000
충북 청주시,아름다운도서관,5000000,600000,550000,6150000
충북 청주시,양촌문고,700000,0,750000,1450000
충북 영동군,어깨동무작은도서관,1000000,0,0,1000000
충북 제천시,에버빌도서관,2000000,0,1000000,3000000
충북 청주시,예꿈문고,200000,0,1100000,1300000
충북 청주시,예인문고,0,0,0,0
충북 제천시,오로라도서관,2000000,0,0,2000000
충북 음성군,오산4리 마을도서관,0,0,1000000,1000000
충북 충주시,오산마을문고,0,0,0,0
충북 청주시,오송상록롯데캐슬@작은도서관,4497370,0,2794500,7291870
충북 청주시,오송호반베르디움@도서관,740000,0,0,740000
충북 청주시,오창대원칸타빌아파트문고,4000000,0,1200000,5200000
충북 청주시,오창우림필유1차도서관,2830000,200000,10660000,13690000
충북 청주시,오창한라꿈터도서관,3750000,0,2918490,6668490
충북 청주시,우리들작은도서관,200000,0,0,200000
충북 청주시,우림나눔도서관,6000000,1200000,4500000,11700000
충북 청주시,은세계도서관,900000,3300000,3400000,7600000
충북 음성군,음성청소년공부방,0,0,0,0
충북 청주시,이안아파트도서관,3600000,0,2000000,5600000
충북 옥천군,이원작은도서관,5000000,23425000,4800000,33225000
충북 진천군,이월면새마을구심문고,287760,15630000,6082240,22000000
충북 청주시,인경리작은도서관,600000,0,0,600000
충북 청주시,임마누엘문고,0,12000000,1470000,13470000
충북 청주시,작은나무큰숲도서관,2000000,0,1000000,3000000
충북 청주시,작은도서관 청춘,1000000,1000000,11405782,13405782
충북 제천시,장락꿈나무도서관,3000000,0,1000000,4000000
충북 제천시,장락한우리작은도서관,1500000,0,600000,2100000
충북 괴산군,장연면새마을문고,0,0,0,0
충북 청주시,정다운도서관,540,600,290,1430
충북 보은군,정보자료실,3000000,0,0,3000000
충북 제천시,제천 새솔노인도서관,2300000,0,1500000,3800000
충북 제천시,제천시문고센터,0,0,0,0
충북 제천시,제천푸른도서관,1000000,0,2500000,3500000
충북 영동군,주곡지역아동센터문고,0,0,0,0
충북 충주시,주덕문고,170000,0,650000,820000
충북 청주시,주민도서관 '글마루',2564580,2482630,173590,5220800
충북 청주시,중앙작은도서관,6410000,0,2710000,9120000
충북 충주시,중앙탑작은도서관,6500000,20000000,11333330,37833330
충북 증평군,증평다문화도서관 나눔,1000000,0,2000000,3000000
충북 제천시,지구별도서관,2000000,0,2000000,4000000
충북 충주시,지혜의 샘 문고,5000000,0,0,5000000
충북 청주시,지혜의등대도서관,600000,0,600000,1200000
충북 보은군,지혜의샘터 작은도서관 ,7440700,26451460,637700,34529860
충북 진천군,진천군초평면새마을작은도서관,0,0,0,0
충북 진천군,진천시민문고,1200000,0,0,1200000
충북 청주시,징검다리아동도서관,0,1180000,0,1180000
충북 청주시,참도깨비,3000000,0,500000,3500000
충북 영동군,참배움의집,500000,0,0,500000
충북 청주시,책동이꿈동이 작은도서관,5000000,0,565920,5565920
충북 청주시,책만보면콩닥,300000,0,0,300000
충북 청주시,책읽는마을도서관,1500000,0,5000000,6500000
충북 제천시,청구꽃다지도서관,2000000,0,1000000,3000000
충북 청주시,청남어린이도서관,3000000,0,4800000,7800000
충북 음성군,청보리 어린이문고,3000000,0,5000000,8000000
충북 옥천군,청산초등학교마을도서관,5000000,0,0,5000000
충북 옥천군,청성작은도서관,0,0,0,0
충북 괴산군,청안면새마을문고,0,0,0,0
충북 청주시,청주해오름도서관,0,0,0,0
충북 괴산군,청천작은도서관,3000000,0,0,3000000
충북 청주시,초롱이네도서관,1000000,0,14370000,15370000
충북 청주시,초장도서관,500000,0,500000,1000000
충북 청주시,충.효 작은도서관,0,0,0,0
충북 괴산군,칠성면새마을문고,0,0,0,0
충북 청주시,칸타빌2단지도서관,2000000,12000000,3000000,17000000
충북 청주시,퀸덤도서관,1200000,5400000,9000000,15600000
충북 영동군,큰사람문고,0,0,0,0
충북 제천시,키즈랜드도서관,2000000,6000000,1500000,9500000
충북 청주시,평생학습관도서실,0,0,0,0
충북 충주시,푸른꿈도서관,1000000,0,10000000,11000000
충북 음성군,푸른마을도서관,1000000,0,2139600,3139600
충북 청주시,푸른숲도서관(가경주공4차),0,0,0,0
충북 청주시,풍성한문고,500000,0,0,500000
충북 청주시,핑크드림도서관,1364000,0,2920000,4284000
충북 충주시,하늘어린이문고,600000,0,600000,1200000
충북 충주시,하늘정원 도서관,0,0,1200000,1200000
충북 청주시,하늘정원 북카페,1000000,0,70000,1070000
충북 청주시,하자지역아동센터,0,0,0,0
충북 영동군,학산면 청소년 공부방,0,13427000,3500000,16927000
충북 청주시,한내들 작은도서관,800000,3600000,800000,5200000
충북 청주시,한무리문고,0,0,0,0
충북 청주시,한빛문고,1000000,4800000,500000,6300000
충북 청주시,함께하는문고,1500000,0,1500000,3000000
충북 청주시,함께하는북카페,1000000,500000,5000000,6500000
충북 청주시,해오름도서관,200000,0,600000,800000
충북 청주시,해품터 직지도서관,5984000,9600000,10940000,26524000
충북 청주시,해피레인보우 작은도서관,0,0,0,0
충북 청주시,행정자료실(북카페),1500000,0,0,1500000
충북 제천시,혜성문고,0,0,0,0
충북 영동군,황간면청소년공부방,0,13427000,700000,14127000
충북 청주시,휴튼문고,1440000,6000000,200000,7640000
충북 충주시,힐스누리작은도서관,6500000,20000000,11333330,37833330
합계,,13839526150,23439073321,17382928311,54661527782
